Aliu	Aliu	properNoun
Ignarro	Ignarro	properNoun
Immonen	Immonen	properNoun
Karailo	Karailo	properNoun
Haouissa	Haouissa	properNoun
Harlem	l' Harlem	noun
Harlem	Harlem	None
PandaLabs	Pandalabs	properNoun
Divac	Divaccord	properNoun
Kline	Kline	properNoun
Petritsch	Pétrite	properNoun
Loznica	Loznica	properNoun
Llukar	Llukar	properNoun
Strahil	Strahil	properNoun
Klosson	Klosson	properNoun
Gattioni	Gattinoni	properNoun
Altran	Altran	properNoun
Kommersant	Kommersant	properNoun
Kopaci	Kopaci	properNoun
Topanas	Topanas	properNoun
Amer	Amer	properNoun
Golemovic	Golemovic	properNoun
Vodnjan	Vodnjan	properNoun
Tola	Tola	properNoun
Soeda	Soeda	properNoun
Vellberg	Vellerg	properNoun
eight-year	huit ans	properNoun
Lundrim	Lundrim	properNoun
Vuga	Viola	properNoun
Markac	Markac	properNoun
Lugar	Lugar	properNoun
Loci	Locu	properNoun
Ramkovski	Ramkovski	properNoun
Mulickoski	Mulickoski	properNoun
Vizak	Vizag	properNoun
Timisoara	Timisoara	properNoun
ask questions	poser des questions	properNoun
Pixies	le lutin	noun
Pixies	la fée	noun
Pixies	Pixier	None
Brinza	Brinza	properNoun
Svinjare	Svinjare	properNoun
Mityo	Mityo	properNoun
Farman	Fermer	properNoun
Ferizaj	Ferizaj	properNoun
Srebric	Srebric	properNoun
Senturk	Sentierk	properNoun
Engelliweb	Engelliweb	properNoun
Srb	SRB	properNoun
Selimaj	Selimaj	properNoun
Gemius	Gemius	properNoun
most of	la plupart de	properNoun
Egro	Egro	properNoun
Pesalov	Pesalov	properNoun
Panagis	Panagis	properNoun
Oleksandr	Oleksandr	properNoun
Gerasmios	Gerasmios	properNoun
Llapaj	Llapaj	properNoun
Anastassiades	Anastassiades	properNoun
Murgash	Murmure	properNoun
Ratomir	Ratomir	properNoun
Tovarnik	Tovarnik	properNoun
Fukunishi	Fukunishi	properNoun
Rugova	Rugova	properNoun
Sintrivani	Sintrivani	properNoun
Slavija	Slavija	properNoun
Drafi	Drafi	properNoun
Antalya	Antalya	properNoun
Boskov	Boskov	properNoun
Grcaliu	Grcaliu	properNoun
Nastase	Nastase	properNoun
Zurof	Zurof	properNoun
Andro	Andro	properNoun
Timotej	Timotej	properNoun
Zarezankova	Zarezankova	properNoun
Isar	Isar	properNoun
Elcin	Elcin	properNoun
Gius	Gius	properNoun
Pasali	Pasali	properNoun
Mendelson	Mendelson	properNoun
Wikimedia	Wikimedia	properNoun
Resi	Resi	properNoun
Brajnovic	Brajnovic	properNoun
Tzavara	Tzavara	properNoun
Teodosije	Teodosije	properNoun
Crombez	Crombez	properNoun
Sprios	Spiros	properNoun
evening	le soir	noun
evening	la soirée	noun
evening	la couche	noun
evening	las couchée	noun
evening	le temps de couchée	noun
evening	soir	None
Naber	Naber	properNoun
Lumnije	Lumnije	properNoun
Lusha	Lusha	properNoun
exert influence	exercer une influence	properNoun
Denizli	Denizli	properNoun
Hotnews	Hotnews	properNoun
Temelin	Temeline	properNoun
Garbin	Garbin	properNoun
Ramou	Ramous	properNoun
Fichtl	Fichtl	properNoun
Baldinini	Baldininini	properNoun
Aruna	Aruna	properNoun
Baroso	Baroso	properNoun
Hellenic	hellénique	adjective
Hellenic	hellénique	None
Nasice	Nasice	properNoun
Becici	Becici	properNoun
Artymata	Artymata	properNoun
Tokatli	Tokatli	properNoun
Koumoutsakos	Koumoutsakos	properNoun
Fylakio	Fylakio	properNoun
Rudin	Rudin	properNoun
Koutouzis	Koutouzis	properNoun
Veski	Veski	properNoun
Biodiesel	Biodiesel	properNoun
Covasna	Covasna	properNoun
Cvrk	Cvrk	properNoun
Oktay	Oktay	properNoun
Lillikas	Lillikas	properNoun
Todor	Todor	properNoun
Rusmaili	Rusmaili	properNoun
Kovos	Kovos	properNoun
Dokanj	Dokanj	properNoun
Vogel	Vogue	properNoun
Ercis	Ercis	properNoun
Mugo	Mugo	properNoun
Asmir	Asmir	properNoun
Bourgas	Bourg	properNoun
Butrinti	Buttrinti	properNoun
Nalbandian	Nalbandien	properNoun
Soldo	Soldo	properNoun
Imer	Imer	properNoun
Frasker	Frasquer	properNoun
Mutercimler	Mutilisateur	properNoun
Belovacikli	Belovacikli	properNoun
Susanu	Susanu	properNoun
Xezair	Xezair	properNoun
Kogioumtzis	Kogioumtzis	properNoun
Stamatis	Stamatis	properNoun
Teleorman	Teleorman	properNoun
Iassy	Iassy	properNoun
Ozeyegin	Oxyegine	properNoun
Maurer	Mutre	properNoun
Averea	Averea	properNoun
Myokan	Myokan	properNoun
BalkanWeb	Balkanweb	properNoun
Alzhar	Alzhar	properNoun
Razvan	Razvan	properNoun
Brosnan	Brosna	properNoun
Novartis	Novartis	properNoun
Negoita	Negoita	properNoun
Ranogajec	Ranogajec	properNoun
Hivzi	Hivzi	properNoun
Glendory	Glenière	properNoun
Mirča	Mirča	properNoun
Zainea	Zainée	properNoun
Meksi	Meksi	properNoun
Maravic	Maravique	properNoun
Warlick	Wharmick	properNoun
Antioch	Antioche	properNoun
Kars	Kars	properNoun
Fekter	Fekter	properNoun
Subrata	Subrata	properNoun
Bregana	Breugana	properNoun
Komninos	Komninos	properNoun
Duraku	Duraku	properNoun
Alon	Alon	properNoun
Perissa	Périsson	properNoun
Volksbank	Volksbank	properNoun
Scheveningen	Scheveningen	properNoun
Kokino	Kokino	properNoun
Budo	Budge	properNoun
Tatic	Tataciant	properNoun
Nielson	Nielson	properNoun
Trantino	Trantino	properNoun
Asma	Asma	properNoun
Kichka	Kichka	properNoun
Nami	Nami	properNoun
Joakim	Joakim	properNoun
Krantja	Krantja	properNoun
Dimo	Dimo	properNoun
Kliman	Kliman	properNoun
Inval	Introduire	properNoun
Spitzis	Spitzis	properNoun
Bahoz	Bahoz	properNoun
Cakovec	Cakovec	properNoun
Eliopoulos	Eliopoulos	properNoun
Onur	Ondulant	properNoun
Coroiu	Coroiu	properNoun
Cavara	Cavara	properNoun
Antonis	Antonis	properNoun
Vinkovacke	Vinkovacke	properNoun
Marsicanin	Marsicanine	properNoun
Wald	Wald	properNoun
Micula	Micula	properNoun
Galicnik	Galicnik	properNoun
Brajshori	Brajshori	properNoun
Roussal	Roussal	properNoun
Nafaka	Nafaka	properNoun
Vardinoyannis	Vardinoyannis	properNoun
Strom	Stress	properNoun
Spilos	Spilos	properNoun
Berati	Berati	properNoun
Hadareni	Hadareni	properNoun
Elery	Épilation	properNoun
get into debt	s'endetter	properNoun
Altas	Altas	properNoun
Rupcea	Rupcéa	properNoun
Agafonova	Agafonova	properNoun
Padovese	Padoisese	properNoun
Bascarsija	Bascarsija	properNoun
Radoi	Radoi	properNoun
Reinhard	Reinhard	properNoun
Minxholi	Minxholi	properNoun
Goshev	Goshev	properNoun
Bikavac	Bikavac	properNoun
Anagnostopoulos	Anagnostopoulos	properNoun
Kilicdaroglu	Kilicdaroglu	properNoun
Stojanovska	Stojanovska	properNoun
Marella	Marella	properNoun
Trivunac	Trivunac	properNoun
Skela	Skela	properNoun
Bofrost	Bofrost	properNoun
Piatra	Piatra	properNoun
Koncar	Koncar	properNoun
Kaarina	Kaarina	properNoun
Beltes	Ceinture	properNoun
Osservatorio	Osservatorio	properNoun
Gregoris	Grégoris	properNoun
Geier	Geige	properNoun
Bals	Balles	properNoun
Evangelismos	Évangelismos	properNoun
Medfilm	MedFilm	properNoun
Theophanous	Théophane	properNoun
Dlamini	Dlamini	properNoun
Battiato	Battiato	properNoun
Ibn	Ibn	properNoun
Masum	Maçon	properNoun
Zahir	Zahir	properNoun
Cabuk	Cabane	properNoun
Haad	Haad	properNoun
Muhiba	Muhiba	properNoun
Alliot	Alliot	properNoun
Keravnos	Keravnos	properNoun
Lezaic	Lézaïque	properNoun
Konushefci	Konushefci	properNoun
Frederico	Frederico	properNoun
Dehaene	Dehaene	properNoun
Bardonecchia	Bardonecchia	properNoun
Voicu	Voicu	properNoun
Turnu	Faire demi-tour	properNoun
Alpaslan	Alpaslan	properNoun
Garipoglu	Garipoglu	properNoun
Hateg	Hébergement	properNoun
Akdag	Akdag	properNoun
Afxentiou	Afxentiou	properNoun
Oteshevo	Oeschévo	properNoun
Lagendijk	Lagendijk	properNoun
Prometheu	le Prométhée	noun
Prometheu	Prométhée	None
Bayandir	Bayandir	properNoun
Sisak	Sisak	properNoun
Aksay	Un aksay	properNoun
Economedia	Économie	properNoun
Holzner	Holzner	properNoun
Reiniger	Reiniger	properNoun
Saxe	Saxe	properNoun
Merlin	Merlin	properNoun
Gazetalajm	Gazetalajm	properNoun
Kishinev	Kishinev	properNoun
Prendi	Prendi	properNoun
Demolli	Démollis	properNoun
Adamakis	Adamakis	properNoun
Tabasaran	Tabasaran	properNoun
Puci	Puci	properNoun
Pribicevic	Pribicevic	properNoun
Efi	EFI	properNoun
Andjelko	Andjelko	properNoun
Skyros	Skyros	properNoun
Haxhimanov	Haxhimanov	properNoun
Naumoska	Naumoska	properNoun
Manouchehr	Manouchehr	properNoun
Kyriakakis	Kyriakakis	properNoun
Marak	Marak	properNoun
Polokwane	Polokwane	properNoun
Trnopolje	Trnopolje	properNoun
Tsantes	Tsantes	properNoun
Platanista	Platanista	properNoun
Tombros	Tombros	properNoun
from that time	depuis ce moment	properNoun
Lopatina	Lopatine	properNoun
Alparslan	Alparslan	properNoun
Poposki	Poposki	properNoun
Pitesti	Piesti	properNoun
Flego	Voler	properNoun
Shkup	Shkup	properNoun
Ipek	IPek	properNoun
Kuvekalovic	Kuvekalovic	properNoun
Aksoy	Akidien	properNoun
Kipkurui	Kipkurui	properNoun
Svishtov	Svishtov	properNoun
Tsenkov	Tsenkov	properNoun
Vojicic	Vociicien	properNoun
Beverage	la boisson	noun
Beverage	le breuvage	noun
Beverage	Boisson	None
Hutupan	Hutupan	properNoun
Katsoras	Katsoras	properNoun
Ilian	Ilienne	properNoun
Kraemer	Kraemer	properNoun
Theodhori	Theodhori	properNoun
distant	loin	adjective
distant	lointain	adjective
distant	éloigné	adjective
distant	distant	adjective
distant	froid	adjective
distant	loin	None
Itar	Itar	properNoun
Bot	Bot	properNoun
Sare	Sarifier	properNoun
Ditiu	Ditiu	properNoun
Vanackere	Vanackere	properNoun
Koray	Koray	properNoun
Lukovac	Lukovac	properNoun
Beppler	Bonder	properNoun
Bulgartabak	Bulgartabak	properNoun
Pellumbi	Pellumbi	properNoun
Cica	CICA	properNoun
Savova	Savova	properNoun
Ivanyi	Ivanyi	properNoun
Sutla	Sula	properNoun
Thodoris	Thodoris	properNoun
Carreras	Carreras	properNoun
Momirovski	Momirovski	properNoun
Paskova	Paskova	properNoun
Radoica	Radoica	properNoun
Ulm	Ulm	properNoun
Lajci	Lajci	properNoun
Smyrni	Smyrni	properNoun
Menahem	Menahem	properNoun
Tvrtko	TVRTKO	properNoun
Maystadt	Putain de maystadt	properNoun
Ibro	Ibro	properNoun
Daewoo	Dawoo	properNoun
Haluk	Haluk	properNoun
Vakuf	Vakuf	properNoun
Ljiljana	Ljiljana	properNoun
Cam	la came	noun
Cam	Came	None
Galiceanu	Galiciceanu	properNoun
Atasay	Atasay	properNoun
Vulpea	Vulpée	properNoun
Dushan	Dushan	properNoun
Prut	Prute	properNoun
Ascona	Ascona	properNoun
at the head of	à la tête de	properNoun
Albatros	Albatros	properNoun
Lakers	Lakers	properNoun
Radovis	Radovis	properNoun
Isuf	Isuf	properNoun
Cüneyt	Cüneyt	properNoun
Ocalan	Ocalan	properNoun
Kleopatra	Kleopatra	properNoun
Ruzsa	Ruzsa	properNoun
Serbedzija	Serbedzija	properNoun
Obor	Obor	properNoun
Popi	Popi	properNoun
Kohen	Kohen	properNoun
Lakicevic	Lakicevic	properNoun
Kohler	Kohler	properNoun
Zaharii	Zaharii	properNoun
Karpuzovska	Karpuzovska	properNoun
Translunar	TRANSUNAR	properNoun
Dumre	Dumre	properNoun
Infotag	Infotag	properNoun
Biolchev	Biolchev	properNoun
Caretta	Cartta	properNoun
Bolintin	Bolintin	properNoun
Poklepovic	Poklepovic	properNoun
Fis	Fis	properNoun
Sebban	Sebban	properNoun
Resita	Resita	properNoun
Brande	Brillant	properNoun
Medziti	Medziti	properNoun
Nakarade	Nakarade	properNoun
Alpina	Alpina	properNoun
Landesmann	Landesmann	properNoun
Zabeila	Zabeila	properNoun
Tro	Trône	properNoun
Csanad	Csanad	properNoun
Mavrou	Mavrou	properNoun
Udrea	Udrea	properNoun
Raufoglu	Raufoglu	properNoun
Spirtounias	Spirounias	properNoun
Deskovska	Deskovska	properNoun
Shikidim	Shikidim	properNoun
Gambino	Gambino	properNoun
Timis	Timis	properNoun
Velchev	Velchev	properNoun
Goro	Goro	properNoun
Cuza	Cuza	properNoun
Hatzigrigoriou	Hatzigrigoriou	properNoun
Sener	Sénateur	properNoun
Nafpaktos	Nafpaktos	properNoun
Helliwell	Helliwell	properNoun
Bilitis	Bilite	properNoun
Vangelija	Vangelija	properNoun
Bizhga	Bizhga	properNoun
Narath	Narath	properNoun
Paprikovac	Paprikovac	properNoun
Olldashi	Olldashi	properNoun
Gusinje	Gusinje	properNoun
Polizu	Polizu	properNoun
Vasilija	Vasilija	properNoun
LeBeau	Lebeau	properNoun
Ozcan	Ozcan	properNoun
Koludrovic	Koludurovien	properNoun
Pajazitim	Pyjazitime	properNoun
Ilieva	Ilieva	properNoun
Abbisnet	Abiss	properNoun
Morelli	Morelli	properNoun
Nezir	Nezir	properNoun
Bilalic	Bilalique	properNoun
Orkan	Orkan	properNoun
Roueida	Roueida	properNoun
Goncz	Goncz	properNoun
Itochu	Itochu	properNoun
Des	Des	properNoun
Rtk	Rtk	properNoun
Znidaric	Znidarique	properNoun
Dalkey	Dalkey	properNoun
Balea	Balnéaire	properNoun
Koumantaros	Koumantaros	properNoun
Fahri	Fahri	properNoun
Vori	Vori	properNoun
Zajas	Zajas	properNoun
Vrdnik	Vrdnik	properNoun
Hutovo	Hutvo	properNoun
Todorevic	Vigoureux	properNoun
Ashkaelia	Ashkaelia	properNoun
Saiki	Saiki	properNoun
Gezim	Gezim	properNoun
Fatma	Fatma	properNoun
Ogreniyor	Oogréniyor	properNoun
Virpazar	Virpazar	properNoun
Shkelqim	Shkelqim	properNoun
Bourgade	Bourg	properNoun
Zarbuzanis	Zarbuzanis	properNoun
Athanasiadis	Athaanasiadis	properNoun
Tsardanisis	Tsardanisis	properNoun
Asanaj	Asanaj	properNoun
search out	découvrir	verb
search out	essayer de trouver	verb
search out	découvrir	None
Hamogelo	Hamogelo	properNoun
Saviola	Saviola	properNoun
Pele	Peler	properNoun
Galeb	Galeb	properNoun
Lietuvos	Lietuvos	properNoun
Heraklio	Heraklio	properNoun
Zekeriya	Zekeriya	properNoun
Morariu	Morariu	properNoun
Turkone	Turkone	properNoun
Rutte	Rudé	properNoun
Erste	Erste	properNoun
Monika	Monika	properNoun
Mioce	Mioice	properNoun
Anderlecht	Anderlecht	properNoun
Junta	la junte	noun
Junta	Junte	None
Haklits	Haklits	properNoun
Polydrossos	Polydrossos	properNoun
Adamesteanu	Adameseanu	properNoun
Sheinfeld	Sheinfeld	properNoun
Kazakova	Kazakova	properNoun
Fratini	Fraîcheur	properNoun
Keyman	Homme clé	properNoun
Lozovo	Lozovo	properNoun
Bridgestone	Bridgestone	properNoun
Pacani	Pacani	properNoun
Busatlija	Busatlija	properNoun
Carrefour	Carrefour	properNoun
Ruud	Rueud	properNoun
Bytyci	Bytyci	properNoun
Airlines	Compagnies aériennes	properNoun
Idlib	Idlib	properNoun
Kampschror	Kampschror	properNoun
Sivasspor	Sivasspor	properNoun
Pashiardis	Cashiardis	properNoun
Turkalj	Turkalj	properNoun
Bakiu	Bakiu	properNoun
Grinzane	Grinzane	properNoun
Suad	Suad	properNoun
Sulejmani	Sulejmani	properNoun
Lierop	Lierop	properNoun
Vandermeulen	Vandermeulen	properNoun
Catalin	Catalin	properNoun
Fetahu	Fétahu	properNoun
Tobago	Tobago	properNoun
Trebos	Trebos	properNoun
Zograf	Zograf	properNoun
Dragor	Dragor	properNoun
Enejd	Eneejd	properNoun
Sanberk	Sanberk	properNoun
Kimmo	Kimmo	properNoun
Ekho	Ekho	properNoun
Motovun	Motovun	properNoun
Copur	Copurier	properNoun
Barba	Barba	properNoun
Tomohito	Tomohito	properNoun
Papastavrou	Papastavrou	properNoun
Bgnes	Bgnès	properNoun
Telenor	Téléviseur	properNoun
Nedždet	Nedždet	properNoun
Hylen	Hylen	properNoun
Glinka	Glinka	properNoun
Gazeta	Gazeta	properNoun
Garifallaki	Garifallaki	properNoun
Ibryama	Ibryama	properNoun
Mirkovo	Mirkovo	properNoun
Blif	Blif	properNoun
Tanjug	Tanjug	properNoun
Oostlander	Oostlander	properNoun
Manchevski	MANCHEVSKI	properNoun
Orovcanec	Orovcanec	properNoun
Aleh	Aleh	properNoun
Domogled	Domogé	properNoun
Ajdacic	Ajdacique	properNoun
Endri	Endri	properNoun
Mega	Méga	properNoun
Prudhoe	Prudhoe	properNoun
Altec	Altec	properNoun
Mobimak	Mobimak	properNoun
Mettlach	Mettlach	properNoun
besides	outre	preposition
besides	en dehors de	preposition
besides	hormis	preposition
besides	en plus de	adverb
besides	en outre	adverb
besides	à part	adverb
besides	par ailleurs	adverb
besides	d'autre	adverb
besides	à l'exception	adverb
besides	outre	None
Horstmann	Horstmann	properNoun
Sterijino	Sterijino	properNoun
Trashani	Trashani	properNoun
Surroi	Rive	properNoun
Protopappas	Protopappas	properNoun
Nerzuk	Nerzuk	properNoun
Murilo	Murilo	properNoun
Slate	l' ardoise	noun
Slate	la liste provisoire de candidats	noun
Slate	prévoir	verb
Slate	engueuler	verb
Slate	remporter	verb
Slate	proposer	verb
Slate	critiquer	verb
Slate	réprimander	verb
Slate	Ardoise	None
Agani	Agani	properNoun
Tifon	Titif	properNoun
Borovac	Borovac	properNoun
Architecten	Architecte	properNoun
Hunedoara	Hunedoara	properNoun
Becali	Becali	properNoun
Maiyo	Maiyo	properNoun
Loizos	Loizos	properNoun
Nikaia	Nikaia	properNoun
Ovesea	Ovesea	properNoun
Kladanj	Kladanj	properNoun
Roza	Roza	properNoun
Ahtisari	Ahtisari	properNoun
Radenko	Radenko	properNoun
Shkodra	Shkodra	properNoun
Ciner	Ciner	properNoun
regain composure	regagner le calme	properNoun
Zapresic	Zapresique	properNoun
Hongju	Hongju	properNoun
Neapolis	Napolis	properNoun
Mensbrugghe	Mensbrugghe	properNoun
consumed	consommé	properNoun
Amr	Amus	properNoun
Visoko	Visoko	properNoun
Libera	Libera	properNoun
Korir	Korir	properNoun
Koprinka	Koprince	properNoun
Muntari	Muntari	properNoun
accuse oneself	s'accuser à	properNoun
Melkert	Melkert	properNoun
Pintea	Pintea	properNoun
Zlatibor	Zlatibor	properNoun
Khaldoun	Khaldoun	properNoun
Pinheiro	Pinheiro	properNoun
Hakuho	Hakuho	properNoun
Papavrami	Papavrami	properNoun
Iloka	Iloka	properNoun
Selimovski	Selimovski	properNoun
Istrate	Istrate	properNoun
Salihu	Salihu	properNoun
Charalambous	Charlatifambe	properNoun
Budisalci	Budisalci	properNoun
Zvetelina	Zvetelina	properNoun
Sesum	Sesum	properNoun
Bucur	Bucur	properNoun
Poeteka	Poeteka	properNoun
Rakulj	Rakulj	properNoun
Sozcu	Sozcu	properNoun
Kovtun	Kovtun	properNoun
Innocenti	Innocenti	properNoun
Roni	Roni	properNoun
Snezhana	Snezhana	properNoun
Haleva	Haleva	properNoun
Lopio	Lopio	properNoun
Lutovska	Lutovska	properNoun
Koichuro	Koichuro	properNoun
Cuc	Cuc	properNoun
Arzija	Arzija	properNoun
Zafer	Zéro	properNoun
Gardetto	Gardien	properNoun
Bruktayit	Bruyère	properNoun
Veritas	Veritas	properNoun
Azomures	Azomures	properNoun
Kilic	Kilique	properNoun
Vangjel	Vif	properNoun
Eroglu	Eroglu	properNoun
Barasanin	Barasanine	properNoun
Piri	Piri	properNoun
Diakogiannis	Diakogiannis	properNoun
Cernuda	Cernuda	properNoun
Iliescu	Iliescu	properNoun
Drita	Drita	properNoun
Gopo	Gopo	properNoun
Zajmi	Zajmi	properNoun
Mobtel	Mobtel	properNoun
Andone	Et une	properNoun
Ener	Effort	properNoun
Dyuni	Dyuni	properNoun
Attiki	Attiki	properNoun
Kotraza	Kotraza	properNoun
Jozefina	Jozefina	properNoun
Kiryakov	Kiryakov	properNoun
Trillenium	Trillénium	properNoun
Pevac	Peevac	properNoun
Oleksander	Olekander	properNoun
Meimarakis	Meimarakis	properNoun
Glavaš	Glavaš	properNoun
Korn	Korn	properNoun
Voskopoulos	Voskopoulos	properNoun
Petr	Peintre	properNoun
Atanasie	Atanasie	properNoun
Melos	Mélos	properNoun
Frangovski	Frangovski	properNoun
Uros	Uros	properNoun
Cizre	Cizre	properNoun
Andan	Et un	properNoun
Husak	Handicapé	properNoun
Blanka	Blanka	properNoun
Takeva	Prêteur	properNoun
Kalomira	Kalomira	properNoun
Harakiri	Hara-kiri	properNoun
Knic	Davantage	properNoun
Minto	Minto	properNoun
Mirax	Mirax	properNoun
Arandjelovac	Arandjelovac	properNoun
Asteras	Astéros	properNoun
Akcay	Akcay	properNoun
Interexport	INTEREXPORT	properNoun
Mihajlov	Mihajlov	properNoun
Derikowa	Derikowa	properNoun
Nehum	Nehum	properNoun
Butrint	Butrint	properNoun
Blaz	Blaz	properNoun
Craiului	Craiului	properNoun
Bujku	Bujku	properNoun
Kingson	Kingson	properNoun
Korajlic	Korajlic	properNoun
Tuncel	Tuncel	properNoun
Zahumlje	Zahumlje	properNoun
Ibra	IBRA	properNoun
Mardin	Mardin	properNoun
Smajlovic	Smajlovic	properNoun
Puma	le puma	noun
Puma	Puma	None
Alpogan	Alpogan	properNoun
Katunitsa	Katunitsa	properNoun
Hulea	Hulea	properNoun
Forstner	Forstner	properNoun
Octavian	Octavien	properNoun
Tsvetayeva	Tsvetayeva	properNoun
Moliere	Moliere	properNoun
Sinema	Sinistre	properNoun
Kene	Kene	properNoun
Henneke	Henneke	properNoun
Rozafa	Rozafa	properNoun
Mayreder	Maigre	properNoun
Postavaria	Postavaria	properNoun
Christofias	Christofias	properNoun
Tacan	Tacan	properNoun
Vidanje	Vidanje	properNoun
Filantropia	Filantropie	properNoun
Biljali	Biljali	properNoun
Kingpin	le pivot central	noun
Kingpin	Pivot central	None
Abedin	Abedin	properNoun
Mirek	Mirek	properNoun
Packard	Packard	properNoun
Dravica	Dravique	properNoun
Perivlepta	Périvleta	properNoun
Grigoris	Grinçant	properNoun
Ondokuz	Ondokuz	properNoun
Fortis	Fortis	properNoun
Ristov	Ristoutd	properNoun
Baniyas	Baniyas	properNoun
Noianul	Noianul	properNoun
Tesco	Tesco	properNoun
Tetsuia	Tetsuya	properNoun
Ilyich	Ililich	properNoun
Filko	Filquer	properNoun
Bubanj	Bubanj	properNoun
Carlgren	Carlgren	properNoun
Museref	Muschéfier	properNoun
Cinar	Cinar	properNoun
Tele	Télé	properNoun
Terje	Terje	properNoun
Angelika	Angelika	properNoun
Vetevendosja	Vetevendosje	properNoun
Serdengecti	Serdengecti	properNoun
Theranda	Theranda	properNoun
Cortoglu	Cortoglu	properNoun
Guidia	Guidia	properNoun
Vahit	Vahit	properNoun
Divulje	Divulga	properNoun
Kaniskina	Kaniskina	properNoun
Izudin	Izudin	properNoun
Ibrica	Ibrica	properNoun
Ghodse	Grotte	properNoun
Dragulescu	Dragulescu	properNoun
Samaranch	Samaranch	properNoun
Glenny	Glacial	properNoun
Medley	le mélange	noun
Medley	le pot-pourri	noun
Medley	Mélange	None
Pushkar	Pushkar	properNoun
Kalin	Kalin	properNoun
Demirel	Démiril	properNoun
Malloch	Malloch	properNoun
Kleomenis	Kléomenis	properNoun
Grubu	Gruçon	properNoun
Veria	Veria	properNoun
Kathimerini	Kathimerini	properNoun
Ognyan	Ognyan	properNoun
Kosovapress	Kosovapress	properNoun
Ozkilic	Ozkilic	properNoun
Buxhaku	Biphaku	properNoun
Protoger	Protoger	properNoun
Ghencea	Ghencea	properNoun
Gabric	Gabric	properNoun
Keynesian	Kénésien	properNoun
Curierul	Curierul	properNoun
Ulus	Ulus	properNoun
Bajrush	Bajrush	properNoun
Mirce	Mirure	properNoun
BitDefender	Bitdefender	properNoun
Khatija	Khatija	properNoun
Icil	Icil	properNoun
Itera	Itère	properNoun
Salagoudis	Salagouïs	properNoun
Kurineri	Kurineri	properNoun
Svinarov	Svinarov	properNoun
Voudouris	Voudouris	properNoun
Spahiu	Spahiu	properNoun
Seremb	Serember	properNoun
Belgiorno	Belgiorno	properNoun
Estaing	Estaing	properNoun
Fehmiu	Fehmiu	properNoun
Sadri	Sadri	properNoun
Sapard	Sapard	properNoun
Ramnicu	Ramnicu	properNoun
Milosavljevic	Milosavljevic	properNoun
Mitanovski	Mitanovski	properNoun
Seferis	SEFERIS	properNoun
Nansen	Nansen	properNoun
Memushi	Membrane	properNoun
Samoil	Samoil	properNoun
contrary to	contrairement à	preposition
contrary to	contrairement à	None
Paribas	Paribas	properNoun
Fullani	Fullani	properNoun
Tsonga	Tsonga	properNoun
Kurir	Kurrir	properNoun
Romgaz	Romgaz	properNoun
Sashe	Sashe	properNoun
Seres	Sermes	properNoun
Alici	Alici	properNoun
Byung	Byung	properNoun
Burger	Burger	properNoun
Kada	Kada	properNoun
Standart	Standard	properNoun
Nola	Nola	properNoun
Demokratike	Démocratike	properNoun
Rodeheaver	Rodeeur	properNoun
Tropaisar	Tropaisar	properNoun
Sutina	Sutina	properNoun
Turkiye	Turkiye	properNoun
Sejdic	SEJDIC	properNoun
let lose	lâcher	verb
let lose	lâcher	None
Gerdzhikova	Gerdzhikova	properNoun
Nezavisne	Nezavisne	properNoun
Nedyalkov	Nedyalkov	properNoun
Knezovic	Knezovic	properNoun
Gavrilo	Gavrilo	properNoun
Cotroceni	Corocéni	properNoun
Canak	Canak	properNoun
Herve	Harve	properNoun
sweep out	balayer	properNoun
Profectus	Profectus	properNoun
Devlet	Dévulli	properNoun
Monov	Monov	properNoun
Sungurlu	Sungurlu	properNoun
Ferit	Fermer	properNoun
view	la vue	noun
view	l' avis	noun
view	la vision	noun
view	l' opinion	noun
view	les point de vue	noun
view	le but	noun
view	le regard	noun
view	l' idée	noun
view	le panorama	noun
view	voir	verb
view	regarder	verb
view	examiner	verb
view	visiter	verb
view	étudier	verb
view	avoir un avis	verb
view	vue	None
Ibrahimpasic	Ibrahimpasic	properNoun
Hisar	Hisar	properNoun
Therese	Therese	properNoun
Danzangiin	Danzangiin	properNoun
Zoea	Zoea	properNoun
Oscars	Oscars	properNoun
Stiftung	Stiftung	properNoun
Ksenija	Ksenija	properNoun
Evanghelie	Evanghelie	properNoun
Erbil	Erbil	properNoun
Vaxjo	Vaxjo	properNoun
Hemon	Hémon	properNoun
Bockel	Bocknette	properNoun
Bingaz	Bingaze	properNoun
Madzirov	Madzirov	properNoun
Valinakis	Valinakis	properNoun
Lavtizar	Lavtizar	properNoun
Aronas	Aronas	properNoun
Vrsac	VRSAC	properNoun
Omejec	Omejec	properNoun
Meidani	Meidani	properNoun
Hidroserv	Hidroserv	properNoun
Gotsev	GOTSEV	properNoun
Krasny	Krasny	properNoun
Bilgin	Bilgue	properNoun
Downer	Abattre	properNoun
Krathi	Krathi	properNoun
Pauk	Pauche	properNoun
Meha	MEHA	properNoun
Mitreska	Mitreka	properNoun
Woyzeck	Woyzeck	properNoun
Srbije	Srbije	properNoun
Orozovic	Orozovic	properNoun
Gabela	Gabela	properNoun
Kosor	Kosor	properNoun
Turgay	Turgay	properNoun
Penev	Penev	properNoun
Pianist	pianiste	noun
Pianist	Pianiste	None
Blaku	Blaku	properNoun
Cansu	Cansu	properNoun
Perbreg	Perbreg	properNoun
Mehazi	Mehazi	properNoun
Ketchum	Ketchum	properNoun
Brancusi	Brancusi	properNoun
Loulis	Loulé	properNoun
Ponta	Ponta	properNoun
Koulata	Koulata	properNoun
Sumamed	Subi	properNoun
Zachariou	Zachariou	properNoun
Suheyl	Suheyle	properNoun
Alexi	Alexi	properNoun
Piata	Piata	properNoun
Ademir	Ademir	properNoun
Rahoveanu	Rahoveanu	properNoun
Abdolreza	Abdolreza	properNoun
Lugano	Lugano	properNoun
Ars	Ars	properNoun
Koutev	Koutev	properNoun
Spasic	Spasique	properNoun
Grytsenko	Grytsenko	properNoun
Kurteshi	Kurteshi	properNoun
Cornelissen	Cornelissen	properNoun
Niyazi	Niyazi	properNoun
Puscas	Puscas	properNoun
Koraljka	Koraljka	properNoun
Sot	l' ivrogne invétéré	noun
Sot	Sot	None
Ecole	Écriture	properNoun
Santek	Santel	properNoun
Swedfond	Swedfond	properNoun
Szent	Szent	properNoun
Haljimi	Haljimi	properNoun
Nicosia	Nicosie	properNoun
Branescu	Branescu	properNoun
Pankin	Pankin	properNoun
Agri	Agro	properNoun
Ghetea	Ghète	properNoun
Nolte	Nolte	properNoun
Chelu	Chélu	properNoun
Kallidromos	Kallidromos	properNoun
Weller	Railleur	properNoun
Kocevs	Kocevs	properNoun
Sumeye	Sumeye	properNoun
Bostandzhiev	Bostandzhiev	properNoun
Gjilan	Gjilan	properNoun
Aegean	égéen	adjective
Aegean	Égéen	None
Bartoli	Bartoli	properNoun
Syros	Syrien	properNoun
Spasoje	Spasoje	properNoun
Saryoglu	Saryoglu	properNoun
Gunay	Gunay	properNoun
Karian	Karian	properNoun
Laze	paresser	verb
Laze	se reposer	verb
Laze	ne rien faire	verb
Laze	Paresser	None
Oprisan	Oprisan	properNoun
Nevzat	Nevzat	properNoun
Stathakis	Stathakis	properNoun
Rokas	Rokas	properNoun
Umcevic	Umcevic	properNoun
Domanovici	Domanovici	properNoun
Putokazi	Pukazi	properNoun
Varazdin	Varair	properNoun
Macek	Macek	properNoun
Grga	Groga	properNoun
Gladio	Gladio	properNoun
Vokos	Vokos	properNoun
Ikonomus	Ikonomus	properNoun
Ahmetovic	Ahmetovic	properNoun
Ogutcu	Ogutcu	properNoun
Karlen	Karlen	properNoun
Fischler	Fischler	properNoun
Tiamat	Tiamat	properNoun
Katsounotos	Katsounotos	properNoun
Prokletije	Prokletije	properNoun
straightaway	tout de suite	adverb
straightaway	tout de suite	None
Ulgen	Ulgen	properNoun
Muriquan	Muriquain	properNoun
Efremov	Efremov	properNoun
Knyazhevski	Knyazhevski	properNoun
Palais	Palais	properNoun
Strazhitsa	Strazhitsa	properNoun
EurActiv	EurActiv	properNoun
Karayilan	Karayilan	properNoun
Schlumberger	Schlumberger	properNoun
Magalios	Magalios	properNoun
Mbombela	Mbombela	properNoun
Lindholm	Lindolm	properNoun
Stergiou	Stegiou	properNoun
Stepanovic	Stepanovic	properNoun
Fatmire	Graisse	properNoun
Thumane	Thumane	properNoun
Chromos	Chromos	properNoun
Aksam	Aksam	properNoun
Franjo	Franjo	properNoun
Bimo	Bimo	properNoun
Grabovica	Grabovica	properNoun
Drenas	Drenas	properNoun
Kato	Kato	properNoun
Huber	Huber	properNoun
Enes	Enes	properNoun
Varac	Varac	properNoun
Tigran	Tigran	properNoun
Azeris	Azerais	properNoun
Satyricon	Satyricon	properNoun
Dehari	Dehari	properNoun
Sargisyan	Sargisyan	properNoun
Dimche	Dimche	properNoun
Canlier	Canlier	properNoun
Rajakovic	Rajakovic	properNoun
Oymen	Oymité	properNoun
Nurol	Nurol	properNoun
Fassaris	Fasaris	properNoun
Veselinov	Veselinov	properNoun
Jospin	Jospin	properNoun
Gunaysu	Gunaysu	properNoun
Haradinaj	Haradinaj	properNoun
Pacepa	Pacepa	properNoun
Riblja	Riblja	properNoun
Palihovic	Palihovic	properNoun
Tarlabasi	Tarlabasi	properNoun
Frei	Freid	properNoun
Saklikent	Saklikent	properNoun
Dimovska	Dimovska	properNoun
Sutanovac	Sutanovac	properNoun
Christodoulakis	Christodoulakis	properNoun
Ponor	Ponor	properNoun
Sadullah	Sadullah	properNoun
Tarcatu	Tarcatu	properNoun
Cani	Est-ce-que je peux	properNoun
Ajam	Ajam	properNoun
Kalfoglu	Kalfoglu	properNoun
Korenovo	Korenovo	properNoun
Sabanci	Sabtanci	properNoun
Shefqet	Pistolet	properNoun
Evtimov	Evtitimov	properNoun
Duvanska	DUVANSKA	properNoun
Elefsina	Elefsina	properNoun
Commerzbank	Commerzbank	properNoun
Vojislav	Vojislav	properNoun
Bazac	Bazac	properNoun
in first place	Premièrement	properNoun
EUobserver	Euobsterver	properNoun
Domine	Dominé	properNoun
Radule	Radule	properNoun
Savvopoulos	Savvopoulos	properNoun
Lytras	Lytras	properNoun
Ozturkmen	Ozturkmen	properNoun
Bogoev	Bogoev	properNoun
Sucic	Sucaire	properNoun
Shamlan	Shamlan	properNoun
Kotvun	Kotvun	properNoun
Dimic	Dimique	properNoun
Murgina	Murgina	properNoun
Bilkent	Bilkent	properNoun
Vezmar	Vezmar	properNoun
Gelu	Gelu	properNoun
Selman	Selman	properNoun
Scheele	Scheele	properNoun
Safran	Safran	properNoun
Palaiokrasa	Palaiokrasa	properNoun
Florion	Florion	properNoun
Oprescu	Oprescu	properNoun
Maletic	Malétiques	properNoun
Sinop	Sinop	properNoun
Atomenergoremont	Atomenergoremont	properNoun
Bertogli	Bertogli	properNoun
Gvozd	Gvozd	properNoun
Olio	Olio	properNoun
Pontes	Pont	properNoun
Eruygur	Eruygur	properNoun
Dochia	Dochia	properNoun
Raif	Raif	properNoun
Sergiu	Sergiu	properNoun
Salford	Salford	properNoun
Friedhelm	Friedhelmm	properNoun
Hermannstadt	Hermannstadt	properNoun
Mrdjan	MRDJAN	properNoun
Fani	Fani	properNoun
Tsivlou	Tsivlou	properNoun
Erbakan	Erbakan	properNoun
Dani	Dani	properNoun
Tian	Tian	properNoun
Wilgenburg	Wilgenburg	properNoun
Skender	Skender	properNoun
Andor	Andor	properNoun
Adem	Adem	properNoun
Conal	Conal	properNoun
Pasanski	Pasanski	properNoun
Fauci	Faucier	properNoun
Kypraios	Kypraios	properNoun
Prlenda	Prlenda	properNoun
Fieri	Fieri	properNoun
Sigerus	Sigerus	properNoun
Muttemwar	Mutemwar	properNoun
Ziercke	Ziercke	properNoun
Woring	Entourer	properNoun
Diaconescu	Diagonescu	properNoun
Blokus	Blokus	properNoun
Kolokot	Kolokot	properNoun
Karnak	Karnak	properNoun
Ziare	Zia	properNoun
Paradias	Paradiias	properNoun
Hegel	Hegel	properNoun
Ristovski	Ristovski	properNoun
Tsvetlin	Tsvetlin	properNoun
Drakopoulos	Drakopoulos	properNoun
Gramke	Gramke	properNoun
Benz	Benz	properNoun
Dabene	Dabene	properNoun
Moststroy	La plupart	properNoun
Plevljak	Plevljak	properNoun
back off	ne pas insister	verb
back off	tirer son épingle du jeu	verb
back off	enlever	None
Potocnik	Potocnik	properNoun
Pallaska	Pallaska	properNoun
Debelde	Debelde	properNoun
Veliaj	Veliac	properNoun
Bardakoglu	Bardakcioglu	properNoun
Eken	Eken	properNoun
Namig	Nommer	properNoun
Bodman	Bodom	properNoun
Zoric	Zorique	properNoun
Eide	Ise	properNoun
Lambros	Lambros	properNoun
Sandhofer	Sandhofer	properNoun
Zink	Zink	properNoun
Haraqija	Haraqija	properNoun
Geydarov	Geydarov	properNoun
Abdulati	Abdulati	properNoun
Homen	Homène	properNoun
Kalancopulos	Kalancopulos	properNoun
Brusjanka	Brusjanka	properNoun
Com	Com	properNoun
Nakuci	Nakuci	properNoun
Tancu	Tancu	properNoun
Seid	Seid	properNoun
Sharik	Share	properNoun
Svilajnac	Svilajnac	properNoun
Tomljanovic	Tomljanovic	properNoun
Mossad	Mosad	properNoun
Tuerk	Tuerk	properNoun
Sgouros	Sgouros	properNoun
Logethetis	Lodéthetis	properNoun
Sibovc	SIBOVC	properNoun
Racz	Racz	properNoun
Bloos	Bloos	properNoun
Atanackovi	Atanackovi	properNoun
Kastro	Kastro	properNoun
Unakitan	Unakitan	properNoun
Benzenberg	Benzenberg	properNoun
Cubrovic	Cubrovic	properNoun
hush	le silence	noun
hush	le calme	noun
hush	faire taire	verb
hush	supprimer	verb
hush	faire calmer	verb
hush	faire taire	None
Atomstroyexport	Atomstroyexport	properNoun
Sariciftci	Saricifcici	properNoun
Routemaster	Routamaster	properNoun
Tataru	Tataru	properNoun
Mineco	Mineco	properNoun
Plecas	Plate-forme	properNoun
Vajta	Vajta	properNoun
Simu	Simul	properNoun
Gruz	Gruz	properNoun
Goreshto	Goreshto	properNoun
Vlastimir	Vlastimir	properNoun
Atijas	Ajas	properNoun
Lauretiu	Lauretiu	properNoun
Soulounias	Soulounias	properNoun
Vremya	Vremya	properNoun
Mecir	Mecir	properNoun
Farbman	Farbman	properNoun
Bogazici	Bogazici	properNoun
Ogi	Ogi	properNoun
Avigdor	Avigion	properNoun
Zotos	Zotos	properNoun
Zhelyu	Zhelyu	properNoun
Ilnur	Ilnur	properNoun
Randal	Randonnée	properNoun
Nazan	Nazan	properNoun
Smardan	Smardan	properNoun
Katsu	Katsu	properNoun
Bozdag	Bozdag	properNoun
Klassiki	Klaski	properNoun
Tselentis	Tshentis	properNoun
Karaqeva	Karaqeva	properNoun
Merville	Merville	properNoun
Cukrova	Cukrova	properNoun
Fradkov	Fradkov	properNoun
Kocatepe	Kocatepe	properNoun
Kotzampas	Kotzampas	properNoun
Sapte	SAPTE	properNoun
Papaelia	Papaélie	properNoun
Remeta	Remeta	properNoun
Krezevljakovic	Kresevljakovic	properNoun
Koldin	Koldin	properNoun
Vjetrenica	Vjetrenica	properNoun
Sirketler	Sirketler	properNoun
on the other side of	de l'autre côté de	properNoun
Cetinje	Cétinje	properNoun
Naka	Naka	properNoun
Tsakiris	Tsakiris	properNoun
Panayota	Panayota	properNoun
Saymaz	Saymaz	properNoun
Kosova	Kosova	properNoun
Mehun	Mehun	properNoun
Atanasious	Atanasieux	properNoun
Zong	Zong	properNoun
Viti	Viti	properNoun
Stefanova	Stefanova	properNoun
Mapo	Mapo	properNoun
Gojko	Gojko	properNoun
Kristo	Kristo	properNoun
Vujica	Vujica	properNoun
Schomberg	Schomberg	properNoun
Dimosthenis	Dimosthénis	properNoun
Broechmann	Broechmann	properNoun
Goce Delchev	Goce delchev	properNoun
Salom	Salon	properNoun
Qinglin	Qinglin	properNoun
Dunja	Dunja	properNoun
Ferencak	Ferencier	properNoun
Coskun	Coskun	properNoun
Fintel	Filet	properNoun
Ivicic	Ivicique	properNoun
Kaufland	Kaufland	properNoun
Lagon	Lagon	properNoun
Maleeva	Maleeva	properNoun
Timpul	Tampaud	properNoun
Deronje	Deronje	properNoun
Slavica	Slavica	properNoun
Taylan	Taylan	properNoun
Rogozen	Rogozen	properNoun
Karnobat	Karnobat	properNoun
Villepin	Villepin	properNoun
Lambis	Lambois	properNoun
Gogoski	Gogoski	properNoun
Oguzlu	Oguzlu	properNoun
Vadu	Vadu	properNoun
Erduran	Erduran	properNoun
Poslovni	Poslovni	properNoun
Borova	Borova	properNoun
Botosani	Botosani	properNoun
Skundric	Skundrique	properNoun
Korkmaz	Korkmaz	properNoun
Sulfina	Sulfina	properNoun
Gancheva	Gancheva	properNoun
Backa	Backa	properNoun
Babes	Babes	properNoun
Cancar	Cancar	properNoun
Filippos	Filippos	properNoun
Kallergi	Kallergi	properNoun
Isovic	Isovic	properNoun
Sinjska	Sinjska	properNoun
Pellumb	Pellule	properNoun
Preduzece	Preduzece	properNoun
Kovtchev	Kovtchev	properNoun
Turmen	Tourbillon	properNoun
Bokan	Bokan	properNoun
Majlinde	Majlinde	properNoun
Negroponte	Negroponte	properNoun
Karademir	Karademir	properNoun
Loy	Loyer	properNoun
Ohata	Ohata	properNoun
Klemendi	Klemendi	properNoun
Tomova	Tomova	properNoun
Senin	Senin	properNoun
Tekbir	Tekbir	properNoun
Kavakci	Kavakci	properNoun
Slavchev	Slavchev	properNoun
Sedrenik	Sedrénik	properNoun
Valandovo	Valandovo	properNoun
Gandul	Gandul	properNoun
lay down	déposer	verb
lay down	poser	verb
lay down	coucher	verb
lay down	mettre	verb
lay down	renoncer à	verb
lay down	parier	verb
lay down	remettre à sa place	verb
lay down	poser	None
Naci	Naci	properNoun
Tzekis	Tzekis	properNoun
Standasrt	Standasrt	properNoun
Bunardzik	Bunardzik	properNoun
Besikci	Besikci	properNoun
Velestinlis	Velesttinlis	properNoun
Slavyani	Slavyani	properNoun
Prenga	Prenga	properNoun
Arapov	Arapov	properNoun
Isparta	Isparta	properNoun
Tezak	Textuel	properNoun
Milut	Militaire	properNoun
Vendee	Vendée	properNoun
Pirpiliu	Pirpiliu	properNoun
Tugrul	Tugrul	properNoun
Miocic	Miocic	properNoun
Sezam	Sezam	properNoun
Nikolovska	Nikolovska	properNoun
Indexi	Index	properNoun
Hinterzarten	Hinterzarten	properNoun
Hasguler	Haubineuse	properNoun
Aksal	Aksal	properNoun
Lester	Loup	properNoun
Trifun	Tremblement	properNoun
Rajevac	Rajevac	properNoun
Sanayi	Sanayi	properNoun
Medarevic	Medarevic	properNoun
Agusevic	Agusevic	properNoun
Oreakhovo	Orakhovo	properNoun
Zlokovica	Zlokovica	properNoun
Borboly	Borné	properNoun
Venac	Vénum	properNoun
Cumhur	Cumhur	properNoun
Dunya	Dunya	properNoun
Kuljuh	Kuljuh	properNoun
Dita	Dita	properNoun
Titian	d'un blond vénitien	adjective
Titian	Titian	None
Zaklina	Zaklina	properNoun
Ustun	Ustun	properNoun
Vratnica	Vratnica	properNoun
Agolli	Agolli	properNoun
Marti	Marti	properNoun
Belegu	Belegu	properNoun
Kabashaj	Kabashaj	properNoun
Arkan	Arkan	properNoun
Ferra	Ferra	properNoun
Kural	Kural	properNoun
Zagradjanin	Zagradjanin	properNoun
Partes	Partage	properNoun
Miliyet	Milliyet	properNoun
Baybars	Baybars	properNoun
Petkoski	Pékoski	properNoun
Zrmanja	Zrmanja	properNoun
Sarchievo	Sarchievo	properNoun
Vashid	Vasque	properNoun
Oettinger	Oetarder	properNoun
Fekeza	Fekeza	properNoun
Harzhi	Harzhi	properNoun
Badinter	Badinter	properNoun
Tekin	Tikin	properNoun
Euromax	Euromax	properNoun
Ceka	CEKA	properNoun
Boroujerdi	Boroujerdi	properNoun
nine-year	neuf ans	properNoun
Chievo	Chievo	properNoun
Kladovo	Kladovo	properNoun
Malidanov	Malidanov	properNoun
Koichiro	Koichiro	properNoun
Elliniki	Elliniki	properNoun
Feyzu	Feyzu	properNoun
Ceferin	Ceinferin	properNoun
Osumi	Osumi	properNoun
Nedelcheva	Nedelcheva	properNoun
Hasip	Haussier	properNoun
Dincer	Dincérance	properNoun
Calancea	Calancea	properNoun
link up	enchaîner	verb
link up	embrancher	verb
link up	relier	None
Basri	Bash	properNoun
Silvo	Silveau	properNoun
Bulaja	Bulaja	properNoun
Dedijer	Dedijer	properNoun
Mytilineos	Mytilineos	properNoun
Veso	Veso	properNoun
Tudorescu	Tudorescu	properNoun
Buse	Buse	properNoun
Kapusuz	Kapusuz	properNoun
Rushit	Précipiter	properNoun
Hormove	Hormove	properNoun
Lazarevo	Lazarevo	properNoun
Zegin	Zegin	properNoun
Hrant	Héritier	properNoun
Lunxheria	Lunxheria	properNoun
Obrija	Obrija	properNoun
Kqiku	Kqiku	properNoun
Arnaudov	Arnaudov	properNoun
Vreme	Vreme	properNoun
Wienerberger	Wienerberger	properNoun
Bakopoulou	Bakopoulou	properNoun
Cangi	Cangi	properNoun
Filmhaus	Filmhaus	properNoun
Rado	Rado	properNoun
Halkbank	Halkbank	properNoun
Balatsinou	Balatsinou	properNoun
Gaydei	Gaydei	properNoun
Klecka	Klecka	properNoun
Bayerische	Bayerische	properNoun
Baletic	Balisé	properNoun
Glamoc	Glamoc	properNoun
Kaidanow	Kaiveanow	properNoun
Geci	Geci	properNoun
Varma	Varma	properNoun
Hrebejk	Hrebejk	properNoun
Zed	Zed	properNoun
Remont	Remonter	properNoun
Simchon	Simchon	properNoun
Mitscher	Mitscher	properNoun
Zagovezni	Zagovezni	properNoun
Hecimovic	Hecimovic	properNoun
Pont	Pont	properNoun
Ferroz	Ferroz	properNoun
Sisic	Sisique	properNoun
Luminita	Luminita	properNoun
Liberation	la libération	noun
Liberation	la délivrance	noun
Liberation	l' émancipation	noun
Liberation	le dégagement	noun
Liberation	Libération	None
Usman	Usman	properNoun
Demnievska	Demnievska	properNoun
Erton	Erton	properNoun
Sterpce	Sterpce	properNoun
Rolex	Rolex	properNoun
Kolarac	Kolairac	properNoun
Elazig	Elazig	properNoun
Kljujic	Kljujic	properNoun
Radin	Radin	properNoun
Pais	Pais	properNoun
Iskenderun	Iskenderun	properNoun
Miladin	Miladin	properNoun
Antonije	Antonije	properNoun
Biden	Biden	properNoun
Levack	Lévaquer	properNoun
Oberhausen	Oberhausen	properNoun
Sebahate	Sébahate	properNoun
Saakashvili	Saakashvili	properNoun
Lukashevich	Lukachevich	properNoun
Alpbach	Alpbach	properNoun
Medijana	Médijana	properNoun
Andol	Andol	properNoun
Demirtas	Démiras	properNoun
Gruhonjic	Gruhonjic	properNoun
Kouroi	Kouroi	properNoun
Gërguri	Gëdrguri	properNoun
Landes	Landes	properNoun
Voyager	le voyageur	noun
Voyager	le passager	noun
Voyager	Voyageur	None
Kaewparadai	Kaewparadai	properNoun
Biograd	Biograd	properNoun
Preteni	Preteni	properNoun
Srbovac	Srbovac	properNoun
Vanghelie	Vanghelie	properNoun
Velingrad	Velingrad	properNoun
Fehmi	Fehmi	properNoun
Cavaco	Cavaco	properNoun
vezirship	végétalie	properNoun
Stolisnik	Stolisnik	properNoun
Leko	Leko	properNoun
Kadiri	Kadiri	properNoun
Prizrenit	Prizrenit	properNoun
Antigone	Antigone	properNoun
Vantu	Vain	properNoun
Feketi	Feketi	properNoun
Silviu	Silviu	properNoun
Mujahid	Mujahid	properNoun
Lum	Lutin	properNoun
Birdal	Oiseau	properNoun
Vukosava	Vicukosava	properNoun
Trinitas	Trinitas	properNoun
Gubac	Gubac	properNoun
Ngjela	Ngjela	properNoun
Enkelejda	Enkelejda	properNoun
Konzum	Konzum	properNoun
Saponia	Saponia	properNoun
Valcea	Valcea	properNoun
Zora	Zora	properNoun
Vucicevic	Vicicevic	properNoun
Lupu	Lupu	properNoun
Begaj	Begaj	properNoun
Cezanne	CEZANNE	properNoun
Vojkan	Vojkan	properNoun
Klecovce	Klecovce	properNoun
Strpce	Sppec	properNoun
Detrop	Détroper	properNoun
Kohki	Kohki	properNoun
Dubie	Dubie	properNoun
Leotar	Leotar	properNoun
Primosten	Primosten	properNoun
Indjija	Indjija	properNoun
RosUkrEnergo	Rosukrenergo	properNoun
Berkovitsa	Berkovitsa	properNoun
Mahathir	Mahathir	properNoun
Duisburg	DUISBURG	properNoun
Voiculescu	Voiculescu	properNoun
Poturak	Poêle	properNoun
Ureche	Urine	properNoun
Eleftheriadis	Eleftheriadis	properNoun
Marinko	Marinko	properNoun
Aytekin	Aytekin	properNoun
Sportnet	Sportif	properNoun
Pitties	Pitpesses	properNoun
Butina	Butina	properNoun
Maksa	Maksa	properNoun
Euroins	Euroine	properNoun
Seyfettin	Seyfettin	properNoun
Ruyt	Ruyte	properNoun
Refah	Refaire	properNoun
Korsuvanovas	Korsuvanovas	properNoun
Turan	Turan	properNoun
Antonetti	Antonetti	properNoun
Bugsy	Bogue	properNoun
Groen	Grognement	properNoun
Ergasias	Ergasias	properNoun
Kyriacou	Kyriac	properNoun
Maiziere	Maziere	properNoun
Valdis	Valdis	properNoun
Vau	Vau	properNoun
Bulgare	Bulgare	properNoun
Kohout	Kohout	properNoun
Erwan	Erwan	properNoun
Sajinovic	Sajinovic	properNoun
Emrullah	Emrollah	properNoun
Geras	Germes	properNoun
Bega	Bega	properNoun
Barkey	Garni	properNoun
Gazimestan	Gazimestan	properNoun
Vitezit	Vitzit	properNoun
Artopolescu	Artopolecu	properNoun
Elgin	Elgin	properNoun
the most	le plus	properNoun
Vatech	Vatech	properNoun
Tomanova	Tomanova	properNoun
Lagumdzija	LagumDzija	properNoun
Remus	Remus	properNoun
Andri	Andri	properNoun
Bentler	Bentler	properNoun
Eduards	Éduqueries	properNoun
away from	loin de	properNoun
Kliment	Kliment	properNoun
Vjacaslav	Vjaceslav	properNoun
Stanisor	Stanisor	properNoun
Oberammergau	Oberammergau	properNoun
Zamel	Zamel	properNoun
Plevnik	Plevnik	properNoun
Sakis	Sakis	properNoun
Degfa	Degfa	properNoun
Presevac	Préréval	properNoun
Beronov	Beronov	properNoun
Dabrobosanski	Dabrobosanski	properNoun
Akale	Akale	properNoun
Tsamoglou	Tsamoglou	properNoun
Mittermaier	Mittermaier	properNoun
Kozuhar	Kozuhar	properNoun
Stebleve	Stebleve	properNoun
Krunoslav	Krunoslav	properNoun
Vukovarsko	Vukovarsko	properNoun
Sebahattin	Sebahattin	properNoun
Vulchev	Vulchev	properNoun
Sivan	Sivan	properNoun
Libertas	Libertas	properNoun
Todoric	Todorique	properNoun
Kindermann	Kindermann	properNoun
Hido	Hido	properNoun
Skai	Skai	properNoun
Tribune	la tribune	noun
Tribune	le tribun	noun
Tribune	Tribune	None
Alois	Alois	properNoun
Mundial	Mundial	properNoun
Kavouris	Kavouris	properNoun
Brodotrogir	Brodotrogir	properNoun
Tuskanac	Tuskanac	properNoun
Schoenfelder	Schoenfelder	properNoun
Sezer	Se souilleur	properNoun
Pylarinos	Pylarinos	properNoun
Hardee	Dur	properNoun
Domazet	Domicile	properNoun
punished	puni	properNoun
Zeqiraj	Zeqiraj	properNoun
Sahinkaya	Sahinkaya	properNoun
Mengsuan	Mengsuan	properNoun
Standartnews	Standtarnews	properNoun
Citluk	Citluk	properNoun
Baconschi	Baconschi	properNoun
Ferraios	Ferraios	properNoun
Dokov	Dokov	properNoun
Panayotova	Panayotova	properNoun
Kozloduj	Kozloduy	properNoun
Ugurlu	Ugurlu	properNoun
Dragacica	Dragacica	properNoun
Arcelor	Arcelor	properNoun
Pecani	Pecani	properNoun
Folias	Folia	properNoun
Izi	Izi	properNoun
Curri	Curri	properNoun
Depich	Dépicheur	properNoun
Paparoska	Paparoska	properNoun
Conero	Conero	properNoun
Kanli	Kanli	properNoun
Katardzhieva	KATARDZHIEVA	properNoun
Dobor	Dobor	properNoun
Kavak	Kavak	properNoun
Pogradec	Pogradec	properNoun
Hopa	Hopa	properNoun
Biserka	Biserka	properNoun
Adana	Adana	properNoun
Remetinec	Remettinec	properNoun
Zhekova	Zhekova	properNoun
Limnitis	Fannite	properNoun
Vries	Vrie	properNoun
Awlaki	Abri	properNoun
Konstruktor	Konstruktor	properNoun
Walesa	Walesa	properNoun
Lafiner	Lafiner	properNoun
Ruiste	Ruine	properNoun
Holst	Holst	properNoun
Nadmi	Nadmi	properNoun
Barsamyan	Barsamyan	properNoun
Zupce	Zupce	properNoun
Glauk	Glauque	properNoun
Maxmillion	Maxmillion	properNoun
Gubas	Gubas	properNoun
Fol	Fou	properNoun
Gardini	Gardini	properNoun
Kaludjerski	Kaludjerski	properNoun
Sakip	Sakip	properNoun
Tarradellas	Taradellas	properNoun
Evdokiya	Evdokiya	properNoun
Geroulanos	Geroulanos	properNoun
Milosav	Milosav	properNoun
Lendjer	Lendjer	properNoun
Vlora	Vlora	properNoun
Peze	Piquer	properNoun
Petroiran	Pétroiran	properNoun
Vedad	Vedad	properNoun
Tulln	Tulln	properNoun
Karakas	Karakas	properNoun
Sulley	Sully	properNoun
Bircanivnova	Birculançon	properNoun
Pinhas	Pinhas	properNoun
Rifet	Rifet	properNoun
Koledariya	Koledariya	properNoun
Somerville	Somerville	properNoun
Metodija	Metodija	properNoun
Kerezovic	Kerezovic	properNoun
Dusanka	Dusanka	properNoun
Kissavos	Bisous	properNoun
Andreescu	Andreescu	properNoun
Nacevska	Nacevska	properNoun
Ranko	Ranko	properNoun
Vasilje	Vasilje	properNoun
Sazovski	Sazovski	properNoun
Carstea	Carsea	properNoun
Avantgarde	Avant-garde	properNoun
Zrinko	Zrinko	properNoun
Engrotus	Fragrot	properNoun
Hermannsdorf	Hermannsdorf	properNoun
Krivajevici	Krivajevici	properNoun
Lahoud	Lahoud	properNoun
Zharku	Zharku	properNoun
Tepeku	Tepeku	properNoun
Prodranovic	Prodranovic	properNoun
Sertab	Sertab	properNoun
Pragan	Pragain	properNoun
Voljavca	Voljavca	properNoun
Neoi	Neoi	properNoun
Alavanos	Alavanos	properNoun
Bahcesehir	Bahcesehir	properNoun
Marjan	Marjan	properNoun
Madhe	Madhe	properNoun
Sadikario	Sadikario	properNoun
InnoTrans	Innotrans	properNoun
Floreta	Floreta	properNoun
Pepaj	Pepaj	properNoun
Guimaraes	Guimaraes	properNoun
Stilyan	Stilyan	properNoun
Elkatmis	Elkatmis	properNoun
Avtodetal	Avtodetal	properNoun
Murato	Murato	properNoun
Dikmengil	Dikmengil	properNoun
Gazikent	Gastronomique	properNoun
Kembora	Kembora	properNoun
Sarbu	Sarbu	properNoun
Valtchanova	Valtchanova	properNoun
Florenta	Florenta	properNoun
Herceg	Herbeg	properNoun
Ticha	Ticha	properNoun
Logothetis	Logothétis	properNoun
Wanjiku	Wanjiku	properNoun
Bosilegrad	Bosilegrad	properNoun
Angelos	Angelos	properNoun
Schilegov	Schilegov	properNoun
Muezzin	le muezzin	noun
Muezzin	Muezzin	None
Papasov	Papasov	properNoun
Ceko	CEKO	properNoun
Basten	Se bâtir	properNoun
Vayanos	Vayanos	properNoun
Parson	le pasteur	noun
Parson	le prêtre	noun
Parson	Pasteur	None
talk about	raconter	verb
talk about	rediscuter de	verb
talk about	parler de	None
Zaev	Zaev	properNoun
Grigorije	Grigorije	properNoun
Atici	Atici	properNoun
Bigeste	Bigeste	properNoun
Kammas	Kammas	properNoun
Borjana	Borjana	properNoun
read out	extraire	verb
read out	lire à haute voix	verb
read out	sortir	verb
read out	dicter	verb
read out	lire à haute voix	None
Vasiljevic	Vasiljevic	properNoun
Liezel	Liez	properNoun
Sigurimi	Sigurimi	properNoun
Samijen	Samijen	properNoun
Pastorek	Pastorek	properNoun
Hajdarevic	Hajdarevic	properNoun
Rajlovac	Rajlovac	properNoun
Alakbar	Al Akhbar	properNoun
Guven	Guven	properNoun
Emin	Éminence	properNoun
Hyde	Hydre	properNoun
Botox	Botox	properNoun
Topkapi	Topkapi	properNoun
Goranov	Goranov	properNoun
Majlinda	Majlinda	properNoun
Ponk	Ponk	properNoun
Mrkonjic	Mrkonjic	properNoun
Sirnak	Sirnak	properNoun
Opet	Opet	properNoun
Ibraj	Ibraj	properNoun
Altima	Altima	properNoun
Ebtisam	Ebtisam	properNoun
Parvu	Parvu	properNoun
Kirca	Kirca	properNoun
Ciuca	Ciuca	properNoun
Rogatica	Rogatica	properNoun
Zrze	Zrze	properNoun
Antunes	Antunes	properNoun
Igric	Igric	properNoun
Mapa	Mapta	properNoun
Tutin	Tutin	properNoun
Kounchev	Kounchev	properNoun
Vranopoulos	Vranopoulos	properNoun
Hauer	Hauer	properNoun
Drnovsek	Drnovsek	properNoun
Asamoah	Asamoah	properNoun
Halcom	Hallom	properNoun
Robev	Robev	properNoun
Sherefedin	Sherhefédine	properNoun
Bashkohu	Bashkohu	properNoun
Bjelasnica	Bjelasnica	properNoun
Morten	Mortuaire	properNoun
Slunj	Slunj	properNoun
Roussopoulos	Roussopoulos	properNoun
KulturKontakt	Kulturkontakt	properNoun
Ermir	Ermir	properNoun
Savkov	Savkov	properNoun
Obrenovac	Obrenovac	properNoun
Arbana	Arbana	properNoun
Mamalis	Mamalis	properNoun
Rosu	Rosu	properNoun
Hapsburg	Habsbourg	properNoun
Pluzine	Pluzine	properNoun
Cahan	Cahan	properNoun
Tuncay	Tuncay	properNoun
Markovna	Markovna	properNoun
Nistru	Nistrou	properNoun
Pauletta	Pauletta	properNoun
Babljak	Babljak	properNoun
Olaru	Olaru	properNoun
Neprosteno	Neprosteno	properNoun
Onufri	ONUFRI	properNoun
Akfen	Akfen	properNoun
Pece	Peste	properNoun
Vejseli	Vejseli	properNoun
Kukanova	Kukanova	properNoun
Avasin	Avasin	properNoun
Fasoulas	Fasoulas	properNoun
regardless of	outre le fait que	properNoun
Oreal	Oral	properNoun
Fiorito	Fiorito	properNoun
Kostadin	Kostadin	properNoun
Oomen	Oomen	properNoun
Athenase	Athénase	properNoun
Attilo	Attilo	properNoun
Barbulesc	Barbulesc	properNoun
Danielsson	Danielsson	properNoun
Banski	Banski	properNoun
Tripolis	les Tripoli	noun
Tripolis	Tripolis	None
Seman	Semique	properNoun
Gulbahar	Gulbahar	properNoun
Trkanjec	Trkanjec	properNoun
Patras	Patras	properNoun
Hop	l' houblon	noun
Hop	le saut	noun
Hop	l' étape	noun
Hop	le sautillement	noun
Hop	la sauterie	noun
Hop	sauter	verb
Hop	sautiller	verb
Hop	doper	verb
Hop	faire une courte visite	verb
Hop	sauter à cloche-pied	verb
Hop	Sauter	None
Bagis	Bagis	properNoun
Dox	Dox	properNoun
Obranovic	Obranovic	properNoun
Locar	Local	properNoun
Dorin	Dorin	properNoun
Susnjar	Susnjar	properNoun
Fallujah	Fallujah	properNoun
Ciganlija	Ciganlija	properNoun
Actavis	Actavis	properNoun
Hluboka	Hluboka	properNoun
Balbora	Balbora	properNoun
Musmurati	Musmurati	properNoun
Armutcuoglu	Armutcuoglu	properNoun
Ozeren	Ozeren	properNoun
Manescu	Mansescu	properNoun
Ipekci	IPekci	properNoun
Tokacli	Tokacli	properNoun
Adapazari	Adapazari	properNoun
Bernjak	Bernjak	properNoun
Catez	Catez	properNoun
Lother	Lother	properNoun
Mokaba	Mokaba	properNoun
Vassilis	Vassilis	properNoun
Kranj	Kranj	properNoun
Vejvoda	Vejvoda	properNoun
Abdiu	Abdiu	properNoun
Swinsinfo	Swinsinfo	properNoun
Bejahad	Bejahad	properNoun
Cebren	Cèbre	properNoun
Ulucay	Ulucay	properNoun
Sacra	le sacrum	noun
Sacra	Sacra	None
Sefik	Sefik	properNoun
Olguta	Olguta	properNoun
Mono	mono-	prefix
Mono	Mono	None
Elytis	Élytis	properNoun
Mossialos	Mossialos	properNoun
Aljosha	Aljosha	properNoun
Avadani	Avadani	properNoun
Cvjetkovic	Cvjetkovic	properNoun
Bucim	Buccade	properNoun
Siskel	Siskel	properNoun
Georgievic	Géorgie	properNoun
Ediz	Édieu	properNoun
Preka	Préka	properNoun
Kotooshu	Kotooshu	properNoun
Boyar	Boyard	properNoun
Bajs	Bajs	properNoun
Synaspismos	Synaspismos	properNoun
Grah	Grah	properNoun
Etyen	Résidence	properNoun
Tansu	Tansu	properNoun
Avea	Aveugle	properNoun
Ochiaghe	Oidighe	properNoun
Hidroelektrane	Hidroelektrane	properNoun
Aralica	Aralique	properNoun
Kouchner	Kouchon	properNoun
Enerji	Enerji	properNoun
Tinios	Tinos	properNoun
Fenerbahce	Fénmerbahce	properNoun
Ahmeti	Ahmeti	properNoun
Sufi	soufi	adjective
Sufi	Soufi	None
Kanu	Kanu	properNoun
Nicolescu	Nicolecu	properNoun
Novoberdaliu	Novoboberdaliu	properNoun
Tokes	Tokes	properNoun
Gribincea	Gribinçage	properNoun
Elbasan	Elbasan	properNoun
Dobrinja	Dobrinja	properNoun
Milquet	Milquet	properNoun
Hongqi	Hongqi	properNoun
Besiktas	Besiktas	properNoun
Lampa	Lampa	properNoun
Zymberi	Zymberi	properNoun
Zornitsa	Zornitsa	properNoun
Frenki	Frenki	properNoun
Camozzi	Camozzzi	properNoun
Tucic	Tucique	properNoun
Hayyam	Hayyam	properNoun
Ilidza	Ilidza	properNoun
Goceva	Goyva	properNoun
Odzak	Odzak	properNoun
Gorris	Gorris	properNoun
Verhofstadt	Verhofstadt	properNoun
overachieve	survoler	properNoun
Rohde	Rohde	properNoun
Thy	tes	pronoun
Thy	ton	pronoun
Thy	ta	pronoun
Thy	Tes	None
Skylakakis	Skylakakis	properNoun
Tiberiu	Tibérieur	properNoun
Ozkan	Ozkan	properNoun
Canziba	Canziba	properNoun
Afyonkarahisar	Afyonkarahisar	properNoun
Askeer	Askeer	properNoun
Bablak	Batablak	properNoun
Shinobu	Shinobu	properNoun
Breaz	Breaz	properNoun
Tasciuc	Tacci	properNoun
Okan	Okan	properNoun
Vizjak	Vizjak	properNoun
Ferber	Ferber	properNoun
Bosnjak	Bosnjak	properNoun
Martifer	Martifer	properNoun
Shezai	Shezai	properNoun
Vujadin	Vujadin	properNoun
Kolinda	Kolinda	properNoun
Pars	Pars	properNoun
Raiffeisen	Raiffeisen	properNoun
Claudiu	Claudiu	properNoun
Nasiriyah	Nasiriyah	properNoun
Sevarlije	Sévarlije	properNoun
Ecclestone	Ecclestone	properNoun
Vora	Vora	properNoun
Eurobond	Euro	properNoun
Pironkova	Pironkova	properNoun
Aliona	Aliona	properNoun
Agre	Accord	properNoun
Gizem	Gizem	properNoun
Kurbasic	Kurbasique	properNoun
Uljarevic	Uljarevic	properNoun
Frode	Frode	properNoun
Buzhala	Buzhala	properNoun
Chervenyashka	Chervenyashka	properNoun
Ridvan	Ridvan	properNoun
Cetto	Cetto	properNoun
Toshusai	Toshusai	properNoun
Targu	Cavalier	properNoun
Moda	Moda	properNoun
MediaPro	Mediapro	properNoun
Krumovo	Krumovo	properNoun
Mancham	Mugcham	properNoun
Zdenka	ZDENKA	properNoun
Ralston	Ralston	properNoun
Soskic	Soskic	properNoun
Stjepan	Stjepan	properNoun
Olypmics	les Jeux olympiques	noun
Olypmics	Jeux olympiques	None
with	avec	preposition
with	à	preposition
with	de	preposition
with	sur	preposition
with	avec	None
Zhabar	Zhabar	properNoun
Zvecan	Zvecan	properNoun
Kroes	Kroes	properNoun
Cekirdek	Crekirdek	properNoun
UniCredito	Unicredito	properNoun
Wollfarth	Wollfarth	properNoun
Varga	Varga	properNoun
Grigorova	Grigorova	properNoun
Zarezan	Zarezan	properNoun
Momir	Momir	properNoun
Bitola	Bitola	properNoun
Mejrema	Mejrema	properNoun
Genc	Genc	properNoun
Kyrtsos	Kyrtsos	properNoun
Naydenov	Naydenov	properNoun
Eugenides	Eugénides	properNoun
Copperfield	Copperfield	properNoun
Coppen	Coiffe	properNoun
Ipekyol	Ipekyol	properNoun
Danut	Danut	properNoun
DeLores	Delore	properNoun
Magne	Magne	properNoun
Sishane	Sishan	properNoun
Osten	Osten	properNoun
Aminishiki	Aminishiki	properNoun
Ciric	Cirican	properNoun
Wat	Wat	properNoun
Dokle	Dokle	properNoun
Ternava	Ternava	properNoun
Bantz	Bantz	properNoun
Blagoje	Blagoje	properNoun
Doko	Doko	properNoun
Akbulut	Akbulut	properNoun
Mehanovic	Mehanovic	properNoun
Zaimi	Zaimi	properNoun
Vukicevic	Vikicevic	properNoun
Volen	Volen	properNoun
Ulqini	Ulqini	properNoun
Kicelj	Kicelj	properNoun
make clearer	rendre plus clair	properNoun
Igdir	Igdi	properNoun
Lumturi	Lumturi	properNoun
Melihate	Méliité	properNoun
Saud	Saud	properNoun
Besim	Bêta	properNoun
Terna	Terna	properNoun
Karadjordje	Karadjordje	properNoun
Ceyhan	Creyhan	properNoun
Stoiljkovic	Soiljkovic	properNoun
Kraljica	Kraljica	properNoun
Tammet	Tarmet	properNoun
Wurth	Merveille	properNoun
Kokin	Kokin	properNoun
Colak	Colocataire	properNoun
Platmorma	Platmorma	properNoun
Karkaletsis	Karkaletsis	properNoun
Pcnen	Pcnen	properNoun
Ultra	Ultra	properNoun
Grbavica	Grbavica	properNoun
Galapagos	Galapagos	properNoun
Ushev	USHEV	properNoun
Lukaj	Lukaj	properNoun
Altach	Altach	properNoun
Deslio	Deslio	properNoun
Izmir	Izmir	properNoun
Bijambare	Bijambare	properNoun
Tuzle	Tuzle	properNoun
Paunov	Paunov	properNoun
Soare	Se vanter	properNoun
Ruen	Ruine	properNoun
Mott	Marteau	properNoun
Pecanin	Pécanin	properNoun
Sopalovic	Sopalovic	properNoun
Akalin	Akalin	properNoun
Grenoble	Grenoble	properNoun
Stafa	Stafa	properNoun
Ilirian	Ilirienne	properNoun
Gundar	Gundar	properNoun
Vanea	Vana	properNoun
Skriabin	Skriabin	properNoun
Hacivat	Hacivat	properNoun
Appathurai	Appathurai	properNoun
Sandor	Sandor	properNoun
Balanz	Balanz	properNoun
Piquert	Piquert	properNoun
Linnell	Linnell	properNoun
Grguric	Grécutif	properNoun
Fishkin	Peau de pêche	properNoun
Florea	Flore	properNoun
Mevlana	Mevlana	properNoun
Midheta	Midheta	properNoun
Pesikan	Pesikan	properNoun
Siptar	Siptar	properNoun
Gounaris	Goundre	properNoun
Baltzar	Balte	properNoun
Mandel	Mandel	properNoun
Mortiz	Mortiz	properNoun
Kriventsov	Kriventsov	properNoun
Nikolle	Nikolle	properNoun
Koevski	Koevski	properNoun
Valean	Valeen	properNoun
Sirius	Sirius	properNoun
Arahova	Arahova	properNoun
Madaric	Maillot	properNoun
Oyak	Oyak	properNoun
Homs	Homes	properNoun
Danilovich	Danilovich	properNoun
Hallenberg	Hallenberg	properNoun
Neshev	Neshev	properNoun
Ottendorf	Ottendorf	properNoun
at the height of	à la hauteur de	properNoun
Elan	l' énergie	noun
Elan	Élan	None
Katsaris	Katsaris	properNoun
Gorna Orjahovica	Gorna Orjahovica	properNoun
Pandermalis	Pandermalis	properNoun
Nafije	Nafije	properNoun
Kuljaca	Kuljaca	properNoun
Ananiev	Ananiev	properNoun
Ergenc	Ergenc	properNoun
Rocen	Rocen	properNoun
Vukajlovic	Vukajlovic	properNoun
Statovci	Statovci	properNoun
Keljmendi	Keljmendi	properNoun
Mobilkom	Mobilkom	properNoun
Gulen	Grognon	properNoun
Gagovo	Gagovo	properNoun
Doru	Doru	properNoun
Sejdiu	Sejdiu	properNoun
Trninic	Trninique	properNoun
Delahunt	Delahunt	properNoun
Tirumesh	Timbre	properNoun
Kyiv	Kiev	properNoun
Fukuda	Fukuda	properNoun
Kaloyan	Kaloyan	properNoun
GusGus	Gusgus	properNoun
Shpic	Épicé	properNoun
Schuman	Schuman	properNoun
Kounellis	Kounellis	properNoun
Skenderi	Skendéri	properNoun
Caput	Capricieux	properNoun
Merima	Merima	properNoun
Theofania	Theofania	properNoun
Zena	Zena	properNoun
Katerini	Katerini	properNoun
Akgonul	Akgonul	properNoun
Safioleas	Safioleas	properNoun
Atel	Atel	properNoun
Cornakov	Cornakov	properNoun
Sounion	Sounion	properNoun
Lac	le lac	noun
Lac	la laque	noun
Lac	Lac	None
Ramajli	Ramajli	properNoun
Svante	Svante	properNoun
Halilaj	Halilaj	properNoun
Valon	Valon	properNoun
Memija	Memija	properNoun
Kek	Crevasse	properNoun
Panda	le panda	noun
Panda	Panda	None
Amdi	AMDI	properNoun
Kalam	Kalam	properNoun
Rusev	Rusev	properNoun
Comanu	Comanu	properNoun
Bizitek	Bizitek	properNoun
Liciu	Liciu	properNoun
Ossipov	Ossipov	properNoun
Kizen	Kizen	properNoun
Haliti	Haliti	properNoun
Sibel	Sibel	properNoun
Putnik	Putnik	properNoun
Voula	Vula	properNoun
Isakovic	Isakovic	properNoun
Calasan	Calasan	properNoun
Corneanu	Maïenu	properNoun
Cheia	Cheia	properNoun
Boll	la graine du lin	noun
Boll	Bée	None
Dursun	Dursun	properNoun
Koefner	Koefner	properNoun
Kojo	Kojo	properNoun
Revija	Revija	properNoun
Micarelli	Micraelli	properNoun
Kathuria	Kathurie	properNoun
Bajgora	Bajgora	properNoun
Akdamar	Akdamar	properNoun
Abbondanzieri	Abbondanzieri	properNoun
Fier	Fier	properNoun
Zeqo	Zeqo	properNoun
Iguana	Iguana	properNoun
Ringas	Ringas	properNoun
Kircho	Kircho	properNoun
Interbank	Interbancaire	properNoun
Preda	Préda	properNoun
in other news	dans d'autres nouvelles	properNoun
Olja	Olja	properNoun
Kalotina	Kalotina	properNoun
Globus	Globus	properNoun
Rafelson	Rafelson	properNoun
Ahmedinejad	Ahmedinejad	properNoun
Kalamata	Kalamata	properNoun
Mesni	Mesni	properNoun
Skavica	Skavica	properNoun
Bolyai	Bolyaï	properNoun
Ptara	Ptara	properNoun
Ozince	Ozce	properNoun
Gijs	Gijs	properNoun
Lushnja	Lushnja	properNoun
Andrijevica	Andrijevica	properNoun
Ismal	Islam	properNoun
Egridir	Egridiir	properNoun
Necmettin	Necmetin	properNoun
Dobrogea	Dobrogogea	properNoun
Paracin	Paracin	properNoun
Rastvortsev	Rastvortsev	properNoun
Kabil	Kabil	properNoun
Susa	Susa	properNoun
Formentini	FORMENTINI	properNoun
Zabari	Zabari	properNoun
Seka	Seka	properNoun
Ajka	Ajka	properNoun
Penspen	Pans-pont	properNoun
Baymyrad	Baymyrad	properNoun
Metrorex	Métrorex	properNoun
Meshic	Maillot	properNoun
Pamporovo	Pamporovo	properNoun
Smajl	Smajl	properNoun
Bodiroga	Bodiroga	properNoun
Urzica	Urzica	properNoun
Davydenko	Davydenko	properNoun
Polgar	Polguar	properNoun
Ping	le tintement	noun
Ping	le cliquettement	noun
Ping	le bruit métallique	noun
Ping	tinter	verb
Ping	cliqueter	verb
Ping	faire un bruit métallique	verb
Ping	Ping	None
Altafaj	Altafaj	properNoun
Riyasat	Riyasat	properNoun
Merdare	Moldare	properNoun
Aydogdu	Aydogdu	properNoun
Cicak	Cicak	properNoun
Hinrichsen	Hinrichsen	properNoun
Engjell	Engunir	properNoun
Perunicic	Pérunique	properNoun
Sofoklis	Canofoklis	properNoun
Krmpotic	Krmpotique	properNoun
Tyrbetari	Tybétari	properNoun
Stamatopoulos	Stamatopoulos	properNoun
Veteazul	Vetazul	properNoun
Brok	Grok	properNoun
Oryahovo	Oryahovo	properNoun
Brookings	Brocing	properNoun
Bamir	Bamir	properNoun
Kosti	Kosti	properNoun
Merlot	Merlot	properNoun
Amro	Amro	properNoun
Alexandrov	Alexandrov	properNoun
Strbacki	Stracki	properNoun
Souda	Souda	properNoun
Solic	Solique	properNoun
Bellocchio	Bellocchio	properNoun
Cicko	Cancot	properNoun
Nata	Nata	properNoun
Visar	Visar	properNoun
Hakurk	Hakurk	properNoun
Wenceslas	Wenceslas	properNoun
Shamata	Shamat	properNoun
Selcuk	Selcuk	properNoun
Skegro	Skegro	properNoun
Viorel	Viorel	properNoun
Doffing	enlever	verb
Doffing	ôter	verb
Doffing	Démontage	None
Aleksandrovic	Aleksandrovic	properNoun
Harcenko	Harcenko	properNoun
Zebari	Zebari	properNoun
for a few months	pour quelques mois	properNoun
Celarevo	Celarevo	properNoun
Petras	Petras	properNoun
Berkan	Berkan	properNoun
Plamen	Plamen	properNoun
Umut	Umut	properNoun
Ormat	Ormat	properNoun
Blagodarna	Blagodarna	properNoun
Karanovo	Karanovo	properNoun
Cherie	Cerise	properNoun
Pernilla	Pernilla	properNoun
Bledar	Bélier	properNoun
Panos	Panos	properNoun
Zyazikov	Zyazikov	properNoun
Serbianna	Serbiana	properNoun
Kountedaki	Kountedaki	properNoun
Kirkpinar	Kirkpinar	properNoun
Bislimovski	Bislimovski	properNoun
Tidjani	Tendjani	properNoun
Balasevic	Balasevic	properNoun
Mitrovac	Mitrovac	properNoun
Aykut	Aykut	properNoun
Rajka	Rajka	properNoun
Hanno	Hanno	properNoun
Qishan	Qishan	properNoun
Govedarica	Govedarica	properNoun
Halcaloglu	Hacaloglu	properNoun
Vravrona	Vravrona	properNoun
Neziraj	Neziraj	properNoun
Novalic	Novalic	properNoun
Traviata	Traviata	properNoun
Exim	Exim	properNoun
Sertov	Sertov	properNoun
Paik	Pék	properNoun
Vranj	Vranj	properNoun
Hasimja	Hasimja	properNoun
Abdullayev	Abdullayev	properNoun
Mustovic	Mustovic	properNoun
Alomar	Alomar	properNoun
Vassilakis	Vassilakis	properNoun
Ingram	Ingram	properNoun
Altinozu	Altinezu	properNoun
Buket	Buket	properNoun
Civici	Civici	properNoun
Fthiotida	Fthiotida	properNoun
Sefedin	Sefédien	properNoun
Europol	Europol	properNoun
Nitin	Nitin	properNoun
Mirela	Mirela	properNoun
Kamarinos	Kamarinos	properNoun
Muallem	Muallem	properNoun
Klitzing	Klitzing	properNoun
Chellomedia	Chellomedia	properNoun
Barrasford	Barrasford	properNoun
Vacek	Vantard	properNoun
Malagurski	Malagurski	properNoun
Koz	Koz	properNoun
Scaroni	Scaroni	properNoun
Artuc	Arc	properNoun
Entifadh	Entifadh	properNoun
Shekeroglu	Sekeroglu	properNoun
Preci	Preci	properNoun
Enkelejd	Enkelejd	properNoun
Poreche	Porsche	properNoun
Azeglio	Azéglio	properNoun
Avala	Avala	properNoun
Papariga	Papariga	properNoun
Impac	Impacser	properNoun
Denstad	Denstad	properNoun
Lathos	Latch	properNoun
Hodak	Hodak	properNoun
Sulejman	Sulejman	properNoun
Ranic	Ranique	properNoun
Paskas	Pâte	properNoun
Shteger	Tremblement	properNoun
Nedzet	Nedzet	properNoun
Akbank	Akbank	properNoun
Taji	Taji	properNoun
Tamis	Tamis	properNoun
Treskavica	Treskavica	properNoun
Zuric	Zurique	properNoun
Panduru	Pandurou	properNoun
Nilufer	Nilufer	properNoun
Istrefi	Istrefi	properNoun
Kesic	Kesic	properNoun
Chionades	Chionades	properNoun
Anibal	Anibal	properNoun
Titulescu	Titulescu	properNoun
Hippy	l' hippie	noun
Hippy	Hippie	None
Beljanski	Beljanski	properNoun
Sincan	Sincain	properNoun
Deo	Deo	properNoun
Erdoğan	Erdoğan	properNoun
Drasko	Drasko	properNoun
Mantovanelli	Mantovanelli	properNoun
Nozadze	Nozadze	properNoun
pump in	refouler	verb
pump in	pomper	None
Cretiel	Cretleil	properNoun
Constantopoulos	Constantopoulos	properNoun
Segolen	Segoler	properNoun
Tufik	Tufik	properNoun
Torocsik	Torocsik	properNoun
Bormio	Bormio	properNoun
Thanet	Thanet	properNoun
Roscam	Roscam	properNoun
Dujarric	Dujarrique	properNoun
Oltenia	Olténie	properNoun
Mediafax	Mediafax	properNoun
Paleochora	Paléochora	properNoun
Sinemorets	Sinemorets	properNoun
Isarescu	Isarsesu	properNoun
Gille	Gile	properNoun
Ravna	Ravar	properNoun
Lidl	Lidla	properNoun
Barassi	Barassi	properNoun
Koleva	Koleva	properNoun
Leuven	Leuvain	properNoun
Gergana	Gergana	properNoun
Eforie	Eforie	properNoun
Sfumato	Sfumato	properNoun
Chervenakov	Camervenakov	properNoun
Wigam	Wigam	properNoun
Stojmenov	Stojmenov	properNoun
Miggirou	MiggiRou	properNoun
Metro	le métro	noun
Metro	Métro	None
Spasov	Spasov	properNoun
Edrit	Edrit	properNoun
Hirschman	Hirschman	properNoun
Vojnevska	Vojnevska	properNoun
Laskovska	Laskovska	properNoun
Edo	Edo	properNoun
Aurescu	Aurescu	properNoun
Clar	Clarifier	properNoun
Fidez	Fidez	properNoun
Kazimir	Kazimir	properNoun
Atemschaukel	Atemschaukel	properNoun
Mamoglu	Mamoglu	properNoun
Fileski	Fichierski	properNoun
Thijs	Thijs	properNoun
Titovic	Titovic	properNoun
Ambrus	Ambrus	properNoun
Elshani	Elsjani	properNoun
Dotan	Dotan	properNoun
Hoyer	Hoyrer	properNoun
Kirpinar	Kirkpinar	properNoun
Kurum	Kurum	properNoun
Draza	Draza	properNoun
Branimir	Branimir	properNoun
Robeva	Robeva	properNoun
Vrelo	Vrelo	properNoun
Cagri	Cagri	properNoun
Pitcovici	Pitcovici	properNoun
Buergenstock	Buergenstock	properNoun
Sukobine	Sukobine	properNoun
Hallgrimur	Hallgrimur	properNoun
Dragnea	Dragnée	properNoun
Okada	Okada	properNoun
Dimiskova	Dimiskova	properNoun
Khach	Khach	properNoun
Rovinari	Rovinari	properNoun
Radanova	Radanova	properNoun
Ljubic	Ljubique	properNoun
Sukru	Sukru	properNoun
Batinjani	Batinjani	properNoun
Hamdo	Hamo	properNoun
Ceamurlia	Cérémonie	properNoun
Koukiadis	Koukiadis	properNoun
Vrancea	Vrancea	properNoun
Guclu	Guclé	properNoun
Oia	Oia	properNoun
Uulu	Uulu	properNoun
Curentul	Credentul	properNoun
Telconsult	Téléconsult	properNoun
Cospanaru	Cospanaru	properNoun
Srejovic	Srejovic	properNoun
Kljuc	Kljuc	properNoun
Agerpres	Aglerpres	properNoun
Kalsin	Kalsine	properNoun
Azem	Azem	properNoun
Malesia	Malésie	properNoun
Kaliopi	Kaliopi	properNoun
Barnev	Barner	properNoun
Loskot	Loskot	properNoun
Mustava	Musava	properNoun
Borbon	Borbon	properNoun
Mahmudi	Mahmudi	properNoun
Dardan	Dardan	properNoun
Stevco	Stevco	properNoun
Vyntras	Vyntras	properNoun
Bevizija	Bevizija	properNoun
Koprivnica	Koprivnica	properNoun
Palexpo	Palexpo	properNoun
Dengbej	Dengbej	properNoun
Hariri	Hariri	properNoun
Kraja	Kraja	properNoun
Sabic	Sabrique	properNoun
Kurdova	Kurdova	properNoun
Lapusnik	Lapusnik	properNoun
Rizzani	Rizzani	properNoun
Barrandov	Barrette	properNoun
Bandila	Bandila	properNoun
Ciampi	Ciampi	properNoun
Sljeme	Sljeme	properNoun
Skele	Skele	properNoun
Oketa	OKETA	properNoun
Mizikacioglu	Mizikacioglu	properNoun
Gigovska	Gigovska	properNoun
Mersel	Maillot	properNoun
Seher	Sécher	properNoun
Giuglaris	Giouglars	properNoun
Siniora	Siniora	properNoun
Sallova	Sallova	properNoun
Athanasia	ATHANASIE	properNoun
Cavour	Cavalier	properNoun
Kerameikos	Keramekos	properNoun
Nafthemporiki	Naftemporiki	properNoun
Hemofarm	Hémofarm	properNoun
Trikala	Trikala	properNoun
Strelet	Strelet	properNoun
Sahza	Sahza	properNoun
Ilazi	Ilazi	properNoun
Paschos	Paschos	properNoun
Maneva	Manteva	properNoun
Papazoglou	Papazoglou	properNoun
Bakone	Bakone	properNoun
Gabor	Gambader	properNoun
Mandur	Mandurent	properNoun
Kirishi	Kirishi	properNoun
Sinani	Sinani	properNoun
Lidija	Lidija	properNoun
Kodra	Kodra	properNoun
Bakreski	Bakreski	properNoun
Omarska	Omarska	properNoun
Montavia	Montavia	properNoun
Wiegand	Wiegand	properNoun
Jozi	Jozi	properNoun
Kurier	Kurier	properNoun
Grozdanov	Grozdanov	properNoun
Chengdu	Chengdu	properNoun
Uta	Uta	properNoun
Ilmiye	Ilmiye	properNoun
Zupic	Zupic	properNoun
Arnhem	Arnhem	properNoun
Hammam	Hammam	properNoun
Tuzlanska	Tuzlanska	properNoun
Smiljan	Smiljan	properNoun
Nunn	Nunn	properNoun
Naguib	Naguib	properNoun
Serghei	Serghei	properNoun
Minxhozi	Minxhozi	properNoun
Larsson	Larsson	properNoun
Majinski	Majinski	properNoun
Kozara	Kozara	properNoun
Korisha	Korisha	properNoun
Aubenas	Aubenas	properNoun
prepay	prépayer	properNoun
Akis	Akis	properNoun
Todevska	Todudevska	properNoun
Dragasani	Dragasani	properNoun
Gogol	Gogol	properNoun
Snipes	Snipes	properNoun
Breza	Breza	properNoun
Tofalvi	Tofalvi	properNoun
Hajuj	Hajuj	properNoun
Bedrana	Bedrana	properNoun
Papalazarou	Papalazarou	properNoun
Nguen	Nguen	properNoun
Ded	Dédicace	properNoun
Calija	Calija	properNoun
Karaveli	Karaveli	properNoun
Dogme	Dogme	properNoun
Miljenic	Miljénique	properNoun
Pudaric	Pudaric	properNoun
Ramaj	Ramaj	properNoun
Netbridge	Netbridge	properNoun
Kalovics	Kalovics	properNoun
Cakaj	Cakaj	properNoun
Purivatra	Purivatra	properNoun
Liu	Liu	properNoun
Shala	Shala	properNoun
Olters	Oller	properNoun
Kiriakov	Kiriakov	properNoun
ProCredit	Procrédit	properNoun
Tanrikulu	Tanrikulu	properNoun
Sambrakos	Sambrakos	properNoun
Skakavac	Skakavac	properNoun
Sigma	Sigma	properNoun
Nasia	Nasia	properNoun
Tattarescu	Tattarescu	properNoun
Donev	Donev	properNoun
Alfa	Alfa	properNoun
Ueli	Ueli	properNoun
Mjaku	Mjaku	properNoun
Canadiana	Canadiana	properNoun
Sharshenovich	Sharhenovich	properNoun
Aliriza	Aliriza	properNoun
Eliade	Eliade	properNoun
ContourGlobal	Contourglobal	properNoun
Temerin	Temérine	properNoun
Mjaft	Mjef	properNoun
Sotiropoulos	Sotiroposoulos	properNoun
Molik	Milik	properNoun
Vidusevac	Vidusevac	properNoun
Aldin	Aldin	properNoun
Shoigu	Shoigu	properNoun
Kopanja	Kopanja	properNoun
Gotovac	Gotovac	properNoun
Türbedar	Türbedar	properNoun
Ecevit	Ecevit	properNoun
Reding	Redresser	properNoun
three-year	Trois ans	properNoun
Cosmin	Cosmin	properNoun
Tomovic	Tomovic	properNoun
Cigdem	Cigdem	properNoun
Naftogaz	Naftogaz	properNoun
Kirisci	Kirisci	properNoun
Nikoultchina	Nikoultchina	properNoun
Lyzichko	Lyzichko	properNoun
Vassiliou	Vassiliou	properNoun
Preziosi	Preziosi	properNoun
Mahsum	Mahsum	properNoun
Matea	Macea	properNoun
Dragojevic	Dragojevic	properNoun
Karadzoski	Karadzoski	properNoun
Balyoz	Balyoz	properNoun
Orikum	Orikum	properNoun
Mesic	Mésique	properNoun
Cadenabbia	Cadenabbia	properNoun
Konda	Konda	properNoun
Mahmut	Mahmut	properNoun
Edina	Edina	properNoun
Takac	Takac	properNoun
Slayer	Slayer	properNoun
Gatlif	Gatlif	properNoun
Unver	Offenser	properNoun
Intersat	Intersat	properNoun
Gosset	Gossé	properNoun
Behrakis	Behrokis	properNoun
Burdur	Burdeur	properNoun
Zintan	Zintan	properNoun
Blagoj	Blagoj	properNoun
Lubroth	Lubroth	properNoun
Kalchev	Kalchev	properNoun
Kushnarev	Kushannarev	properNoun
Kutlukhan	Kutlukhan	properNoun
Binder	le liant	noun
Binder	le classeur	noun
Binder	le relieur	noun
Binder	la lieuse	noun
Binder	le bandage	noun
Binder	l' entrait	noun
Binder	Liant	None
Eleftheriades	Eleftheriades	properNoun
Eltayeb	Eltayeb	properNoun
Radovan	Radovan	properNoun
Septimius	Septime	properNoun
Boc	Boc	properNoun
Costiniu	Costinu	properNoun
Petrova	Petrova	properNoun
Demir	Démir	properNoun
Pasang	Pasang	properNoun
Nedelkovska	Nedelkovska	properNoun
Muhongo	Muhongo	properNoun
Lafazanis	Lafazanis	properNoun
Neziri	Neziri	properNoun
Barysch	Barysch	properNoun
Independent	indépendant	adjective
Independent	autonome	adjective
Independent	privé	adjective
Independent	l' indépendant	noun
Independent	Indépendant	None
Popovo	Popovo	properNoun
DaKino	Dakino	properNoun
Baser	bas	adjective
Baser	vil	adjective
Baser	ignoble	adjective
Baser	indigne	adjective
Baser	vulgaire	adjective
Baser	faux	adjective
Baser	servile	adjective
Baser	mesquin	adjective
Baser	Bascule	None
Upsurt	Upsurt	properNoun
Navruz	Navruz	properNoun
Karoyan	Karoyane	properNoun
Baile	Baime	properNoun
Xiros	Xiros	properNoun
Krizaj	Krizaj	properNoun
Nacional	Nacional	properNoun
Ostergaard	Ostergaard	properNoun
Ajaks	Ajaks	properNoun
Ibrahimaj	Ibrahimaj	properNoun
Kico	Kico	properNoun
Indermit	Indermit	properNoun
Maestral	Maestar	properNoun
Nemec	Nemec	properNoun
Celikkol	Celikkol	properNoun
Petrozzi	Petrozzi	properNoun
Istre	Istre	properNoun
Makhmur	Makhmur	properNoun
Izbasa	Izbasa	properNoun
Milchin	Milchin	properNoun
Gardot	Gardien	properNoun
Cili	Cili	properNoun
Elektrotehna	Elektrotehna	properNoun
Lemierrie	Lemierrie	properNoun
Lorik	Lorik	properNoun
Aqua	l' aqua	noun
Aqua	l' eau	noun
Aqua	Aqua	None
Unler	Maller	properNoun
Kutbettin	Kutbettin	properNoun
Rompres	Rompres	properNoun
Pajaziti	Pyjaziti	properNoun
Skena	Skena	properNoun
Pinjo	Pinjo	properNoun
far away	loin	adverb
far away	très loin	adverb
far away	au loin	adverb
far away	loin	None
misappropriate	détourner	verb
misappropriate	voler	verb
misappropriate	détourner	None
Koka	Koka	properNoun
Citlioglu	Citlioglu	properNoun
Zylyftari	Zyclyftari	properNoun
Suleiman	Sutuiman	properNoun
Gardianul	Gardien	properNoun
Basta	Basta	properNoun
Basbunar	Basbunaire	properNoun
Partizan	Partizan	properNoun
Vecernji	Vecernji	properNoun
Bakira	Bakira	properNoun
Amra	Amra	properNoun
Losinj	Losinj	properNoun
Chrysohoidis	Chrysohoidis	properNoun
Moselle	la moselle	noun
Moselle	Moselle	None
Tchomakov	Tchomakov	properNoun
Sik	Sik	properNoun
Merko	Merko	properNoun
Penkova	Penkova	properNoun
Stanka	Stanka	properNoun
Pivellina	Pivellina	properNoun
Charisteas	Charisteas	properNoun
Grozev	Grozeev	properNoun
Petkim	Petkim	properNoun
Wozniacki	Wozniacki	properNoun
Cinemania	Cinémania	properNoun
Rytel	Rytel	properNoun
Ghinea	Ghinée	properNoun
Karaotok	Karaotok	properNoun
Kissamos	Kissamos	properNoun
Timocka	Timocka	properNoun
Fresenco	Fresenco	properNoun
Abaci	l' abaque	noun
Abaci	le compteur	noun
Abaci	Abaci	None
Idrizi	IDrizi	properNoun
Cioroianu	Cioroianu	properNoun
Hamiti	Hamiti	properNoun
Neeraj	Neeraj	properNoun
Minghella	Minghella	properNoun
Vinistra	Vinistra	properNoun
Biljana	Biljana	properNoun
Plakalo	Plakalo	properNoun
Pavol	Pavol	properNoun
Lund	Lund	properNoun
Rodham	Rodham	properNoun
Cero	Cero	properNoun
Tekke	Tekke	properNoun
Manjola	Manjola	properNoun
Sidarta	Sidarta	properNoun
Shahini	Shahini	properNoun
Orban	Orban	properNoun
Moisiu	Moisiu	properNoun
Karatzas	Karatzas	properNoun
Halai	Halai	properNoun
Ceman	Ceman	properNoun
Zefi	Zefi	properNoun
Kapitan	Kapitaine	properNoun
Karakul	Karakul	properNoun
Ozgun	Ozgun	properNoun
Rosenstone	Rosenstone	properNoun
Citaku	Citaku	properNoun
Puls	Pulsation	properNoun
Mesut	Mesut	properNoun
Bjolstred	Bjolstré	properNoun
Spahija	Spahija	properNoun
Botas	Botas	properNoun
Ifantis	Icantis	properNoun
Xani	Xani	properNoun
Temizel	Temizel	properNoun
Saadat	Saadat	properNoun
Vasili	Vasili	properNoun
Saylan	Saylan	properNoun
Ipsos	Ipsos	properNoun
Arsenova	Arsenova	properNoun
Terpani	Tépani	properNoun
TerraNet	Terranier	properNoun
Lis	Lis	properNoun
Aricam	Aricam	properNoun
the whole time	tout le temps	properNoun
Kobas	Kobas	properNoun
Boneva	Boneva	properNoun
Furchgott	Furchgott	properNoun
Girardot	Girardot	properNoun
Irfan	Irfan	properNoun
Bin Laden	Bin	properNoun
Gafic	Gazeux	properNoun
Altindag	Altindag	properNoun
Helsinki	Helsinki	properNoun
Unionbank	Unionbank	properNoun
Cavar	Cavar	properNoun
Robben	Robben	properNoun
Ruzica	Ruzica	properNoun
Preslava	Preslava	properNoun
Probistip	Probistipe	properNoun
Mitulescu	Mituscu	properNoun
Rogova	Rogova	properNoun
Sprecani	Sprecani	properNoun
DidArt	Distart	properNoun
Ritopek	Ritopek	properNoun
Bebac	Babac	properNoun
Sirri	Sirri	properNoun
Ugricic	Ugricic	properNoun
Dorcic	Dorcique	properNoun
Andi	Et moi	properNoun
Mitsuo	Mitsuo	properNoun
Sanjak	Sanjak	properNoun
Roesler	Railleur	properNoun
Stubb	Sombrer	properNoun
Gorishti	Gorishti	properNoun
Cvjetko	Cvjetko	properNoun
Kras	Kras	properNoun
Lefke	Lefke	properNoun
Bazaar	le bazar	noun
Bazaar	Bazar	None
Enco	Enco	properNoun
Gunes	Armes à feu	properNoun
Sueda	Suède	properNoun
Carlsberg	Carlsberg	properNoun
Frikom	Frikom	properNoun
Ocak	Ocaque	properNoun
Canakkale	Canakkale	properNoun
Atermon	Atermon	properNoun
Subhi	Subhi	properNoun
Lajm	Lajm	properNoun
Bayancuk	Bayancuk	properNoun
Pantelimon	Pantelimon	properNoun
Kriva	Kriva	properNoun
Hysa	Hysta	properNoun
Panajotovic	Panajotovic	properNoun
Gane	Gagne	properNoun
Weiler	Weiler	properNoun
Pecinici	Pecinici	properNoun
Krivolak	Krivolak	properNoun
Sanja	Sanja	properNoun
Sarkisian	Sarkisien	properNoun
Medjedovic	Medjedovic	properNoun
Fuerteventura	Fuerteventura	properNoun
Nova Zagora	Nova Zagora	properNoun
Ayalon	Ayalon	properNoun
Biotech	biotechnologies	properNoun
Athanase	Athanase	properNoun
Muresului	Mureslui	properNoun
Montepaski	Montepaschi	properNoun
Balanzo	Balanzo	properNoun
Vila	Vila	properNoun
Steinhilb	Steinhilb	properNoun
Lushnje	Lushnje	properNoun
Dosen	Deuil	properNoun
Mastalic	Mastalique	properNoun
Bilman	Bilman	properNoun
Saatchi	Sachet	properNoun
Adamantios	Adamantios	properNoun
Ekobis	Ekobis	properNoun
Xiexia	Xiexia	properNoun
Puntala	Puntala	properNoun
Kranjcar	Kranjcar	properNoun
Kranjska	Kranjska	properNoun
Gormley	Goutte	properNoun
Uzelac	Uzelac	properNoun
Puris	Puis	properNoun
Planum	Plantume	properNoun
Alexandroupoli	Alexandroupoli	properNoun
Zadorozhnaya	Zadorozhnaya	properNoun
Bosto	Bosto	properNoun
Kivotos	Kivotos	properNoun
Balkaniada	Balkaniada	properNoun
Ferri	ferro-	prefix
Ferri	Ferri	None
Ivailovgrad	Ivailovgrad	properNoun
Eurika	Eurika	properNoun
Aurel	Aurel	properNoun
Bajec	Bajec	properNoun
Germia	Germe	properNoun
Laursen	Laurier	properNoun
Zate	Zate	properNoun
Burcu	Burcu	properNoun
Daghan	Daghan	properNoun
Oncescu	Tiscescu	properNoun
Kehayioylou	Kehayioylou	properNoun
Devrimci	Devrimci	properNoun
Lehtinen	Lehtinen	properNoun
Alilovic	Alilovic	properNoun
Srpac	Srpac	properNoun
Vc	Vc	properNoun
Tatul	Taul	properNoun
Sekiraqa	Sekiraqa	properNoun
Marga	Marga	properNoun
Myria	Myria	properNoun
Philelefteros	Phileleftheros	properNoun
Fuentes	Fou	properNoun
Artois	Artois	properNoun
Kishev	Kichev	properNoun
Gantar	Gantar	properNoun
Drage	Faire irriter	properNoun
Vitorino	Vitorino	properNoun
Slezovic	Somzovic	properNoun
Akihito	Akihito	properNoun
Incirlik	Incirlik	properNoun
Vidolov	Vidolov	properNoun
Cote	le parc	noun
Cote	Cote	None
Garelli	Garelli	properNoun
Slon	Slon	properNoun
Ozlem	Ozlem	properNoun
Uzan	Uzan	properNoun
Nardis	Nardis	properNoun
Tudjman	Tudjman	properNoun
Kretakor	Krekor	properNoun
Halimi	Halimi	properNoun
Kilis	Kilon	properNoun
Helmi	Helmi	properNoun
Vanco	Vanco	properNoun
Vlasios	Vlasios	properNoun
Mitrakos	Mitraquin	properNoun
Glusac	Glusac	properNoun
Cocorovska	Cocorovska	properNoun
Leme	Leme	properNoun
Limdal	Limdal	properNoun
Boljevic	Boljevic	properNoun
Culum	Culètre	properNoun
Saizescu	Saizescu	properNoun
Cas	CAS	properNoun
Nuh	NUH	properNoun
Elerman	Elerman	properNoun
Behmen	Behmen	properNoun
Ajvaz	Ajvaz	properNoun
Akdeniz	Akdeniz	properNoun
Privrednik	Privrednik	properNoun
Krajisnik	Krajisnik	properNoun
Agogo	Agogo	properNoun
Orsat	Orsat	properNoun
Crnjak	Crnjak	properNoun
Braic	Braïque	properNoun
Miladinovci	Miladinovci	properNoun
Lukac	Lukac	properNoun
Damjanovska	Damjanovska	properNoun
Novator	Novateur	properNoun
Seren	Serré	properNoun
Skeljzen	Skeljzen	properNoun
Isaraj	Isaraj	properNoun
Siropulo	Sirophulo	properNoun
Tayyip	Taylyip	properNoun
Vasove	Vasot	properNoun
ten-year	dix années	properNoun
Petyo	Peyo	properNoun
Gudovic	Gudovic	properNoun
Morina	Mora	properNoun
Hawtin	Hawtin	properNoun
Shera	Shera	properNoun
Benetton	Benetton	properNoun
Asmussen	Asmussen	properNoun
Cerovina	Cervina	properNoun
Astibo	Astibo	properNoun
Rusen	Ruse	properNoun
Zdravko	Zdravko	properNoun
Katsantonis	Katsantonis	properNoun
Mirow	Mirou	properNoun
Pelin	Pelin	properNoun
Patissia	Patientia	properNoun
Tihi	Tihi	properNoun
Ferhat	Ferhat	properNoun
Fetesti	Fetesti	properNoun
Munja	Munja	properNoun
Agnesë	Agnesë	properNoun
Portile	Portimé	properNoun
Ogushi	Ogushi	properNoun
Bure	Bure	properNoun
Albertini	Albertini	properNoun
Lajos	Lajos	properNoun
Helenikpetroleum	Pétrole hellénique	properNoun
Zvezdan	Zvezdan	properNoun
Sopik	Sopik	properNoun
Gowan	Gowan	properNoun
Gibault	Gibult	properNoun
Osmanli	Osmanli	properNoun
Kourtovik	Kourtovik	properNoun
Kocbank	Kocbank	properNoun
Jorgos	Jorgos	properNoun
Cikota	Cikota	properNoun
Datca	Datca	properNoun
Fukuyama	Fukuyama	properNoun
Taubman	Taubman	properNoun
Vladivostok	Vladivostok	properNoun
Frasher	Frastrement	properNoun
Aracinovo	Aracinovo	properNoun
Cartner	Charnière	properNoun
Souflias	Souflial	properNoun
Shahristani	Shahristani	properNoun
Stroe	Pilier	properNoun
Vukovar	Vukovar	properNoun
Boukamal	Boukamal	properNoun
Tasoula	Tasoula	properNoun
Beastie	Bête	properNoun
Easter	les Pâques	noun
Easter	de Pâques	adjective
Easter	pascal	adjective
Easter	Pâques	None
Rushaj	Rushaj	properNoun
Zahovic	Zahovic	properNoun
Pahor	Paume	properNoun
Banovci	Banovci	properNoun
Vedat	Vedat	properNoun
Amiryousefi	Amiryousefi	properNoun
Medjugorje	Medjugorje	properNoun
Rahoveci	Rahoveci	properNoun
Tripunovski	TripUnovski	properNoun
Moiseos	Mousseux	properNoun
Agrinio	Agrrio	properNoun
Manganelli	Manganelli	properNoun
Sanverdi	Sanverdi	properNoun
Apatin	Apatine	properNoun
Szili	Szili	properNoun
Provo	Provo	properNoun
Bromwich	Bromwich	properNoun
Dorjee	Dorjee	properNoun
Komarica	Komarica	properNoun
Frasheri	Frasheri	properNoun
Zupljanin	Zupljanin	properNoun
Thani	Que moi	properNoun
Mutassim	Mutassim	properNoun
a little	un peu	adjective
a little	un peu	adverb
a little	un petit peu	adverb
a little	un peu	None
Marinov	Marinov	properNoun
Zambas	Zambas	properNoun
Kolombias	Kolombias	properNoun
Nadlac	Nadlac	properNoun
Bijaci	Bijaci	properNoun
Interreg	Interreg	properNoun
Nedzad	Nedzad	properNoun
Denkova	Denkova	properNoun
Ilchev	Ilchev	properNoun
Radomir	Radomir	properNoun
Uskudar	Uskudar	properNoun
Bruhn	Bruhn	properNoun
Papoutsis	Papoutsis	properNoun
Wurmbrand	Wurmbrand	properNoun
Lello	Lello	properNoun
Muslibegovic	Musulibegovic	properNoun
Gazprombank	Groombank	properNoun
Fantela	Fantaisie	properNoun
Tyner	Tyner	properNoun
Bratislav	Bratislav	properNoun
Kavala	Kavala	properNoun
Gurtuna	Gurtuna	properNoun
Klose	Klose	properNoun
Lazarica	Lazarica	properNoun
Teruhiko	Teruhiko	properNoun
Montas	Montas	properNoun
Mertinak	Mertinak	properNoun
Ergenekon	Ergenekon	properNoun
Seliu	Seliu	properNoun
Sumadija	Sumadija	properNoun
Orizari	Orizari	properNoun
Paska	Paska	properNoun
Tarr	Tarr	properNoun
Schmeken	Schmeken	properNoun
Tetarom	Tétarom	properNoun
Berane	Baune	properNoun
Antonela	Antonela	properNoun
Macka	Macka	properNoun
Falah	Falah	properNoun
Fuhrer	Fuhrer	properNoun
Bojinov	Bojinov	properNoun
RosGas	Rosgas	properNoun
Drumev	Drumev	properNoun
Nelko	Nelko	properNoun
Evangelia	Évangélien	properNoun
Iftar	Iftar	properNoun
Dunapack	Dunapack	properNoun
Bansko	Bansko	properNoun
Lokomotiv	Lokomotiv	properNoun
Bieniawski	Biéniawski	properNoun
Simonida	Simonida	properNoun
Nobilo	Nobilo	properNoun
Vicenco	Vicenco	properNoun
Sus	Susciter	properNoun
Daskalaki	Daskalaki	properNoun
Doutsis	Doubleis	properNoun
Zuljana	Zuljana	properNoun
Akinci	Akinci	properNoun
Temelko	Temelko	properNoun
Sorina	Sorina	properNoun
Urseanu	Ursanu	properNoun
Petronijevic	Petronijevic	properNoun
Ksia	Ksia	properNoun
Palazov	Palazov	properNoun
Benkovac	Benkovac	properNoun
Mihalache	Mihalache	properNoun
Swinnen	Swinnen	properNoun
Sukarno	Sukarno	properNoun
Mundis	Mundi	properNoun
Slatina	Slatina	properNoun
Larsens	Larsens	properNoun
Kreho	Kreho	properNoun
Haxhillari	Haxhillari	properNoun
Bechtel	Bechtel	properNoun
Samuelson	Samuelson	properNoun
slave-owning society	société d'esclave	properNoun
Faliro	Faliro	properNoun
Szeklersland	Szeklerland	properNoun
Lesi	Lesi	properNoun
Gorbach	Gorbach	properNoun
Kilica	Kilica	properNoun
Kaimas	Kaimas	properNoun
Naegele	Nagèle	properNoun
Helsingin	Helsingin	properNoun
Securitate	Se retrouver	properNoun
Trumbetash	Trumbetash	properNoun
Elefterios	Elefterios	properNoun
Kohl	le khôl	noun
Kohl	Khôl	None
Norimasa	Norimasa	properNoun
Gecheva	Gecteva	properNoun
Srpska	Sdrpska	properNoun
Devrim	Dévrim	properNoun
Kukes	Kukes	properNoun
Storrow	Considérer	properNoun
Eretria	Erétrie	properNoun
Sakhalin	Sakhalin	properNoun
Zekai	Zekai	properNoun
Fuenter	Futé	properNoun
Vaziourakis	Vazourakis	properNoun
Skadarska	Skadarska	properNoun
Gunic	Gunique	properNoun
Cabulev	Cabulev	properNoun
Malina Maala	Malina Maala	properNoun
Karaiskakis	Kariskakis	properNoun
Baydemir	Baydemir	properNoun
Luarasi	Luarasi	properNoun
Trepharm	Trépharm	properNoun
Svetozarevo	Svetozarevo	properNoun
Vittrup	Vitrup	properNoun
Herzigova	Herzigova	properNoun
Midyurov	Midyurov	properNoun
Ilves	ILves	properNoun
Zentralstadion	Zentralstadion	properNoun
Uzbay	Uzbay	properNoun
Garanti	Garanti	properNoun
Cogunluk	Cogunluk	properNoun
Pecinci	Pecinci	properNoun
Haberturk	Habetur	properNoun
Veronika	Veronika	properNoun
Planetarium	le planétarium	noun
Planetarium	Planétarium	None
Osmanov	Osmanov	properNoun
Priebe	Priebe	properNoun
Klajevic	Klajevic	properNoun
Susanj	Susanj	properNoun
Steff	Steff	properNoun
Obrezje	Obrezje	properNoun
Aleksinac	Aleksinac	properNoun
Edis	Edis	properNoun
Dumitrescu	Dumitescu	properNoun
Resetar	Réinitialiser	properNoun
Ovcara	Ovcara	properNoun
Litex	Lithex	properNoun
Sabac	Sabac	properNoun
Misrad	Malheureux	properNoun
Trabzon	Trabzon	properNoun
Shyhrete	Timide	properNoun
Mediapool	Médias	properNoun
Nikolina	Nikolina	properNoun
Gambar	Gambar	properNoun
Hikmet	Hikmet	properNoun
Matesa	Matesa	properNoun
Rabinovich	Rabinovich	properNoun
Sacir	Sacrer	properNoun
Soldat	Soldat	properNoun
Armenian	arménien	adjective
Armenian	l' arménien	noun
Armenian	l' Arménien	noun
Armenian	Arménien	None
Zuzul	Zuzul	properNoun
Abdulselam	Abdulselam	properNoun
B	le si	noun
B	B	None
Talat	Talat	properNoun
Forsberg	Forsberg	properNoun
Nedko	Nédko	properNoun
Kuci	Kuci	properNoun
Nikolcevic	Nikolcevic	properNoun
Erlis	Erlis	properNoun
Hongwei	Hongwei	properNoun
Kilci	Kilci	properNoun
Tuomioja	Tuomija	properNoun
Zabljak	Zabljak	properNoun
Naydenova	Naydenova	properNoun
Kapsi	Kapsi	properNoun
Manchin	Manchin	properNoun
Vinkovci	Vinkovci	properNoun
Plaosnik	Plaosnique	properNoun
Zemunik	Zemunik	properNoun
Multiimpeks	Multipleksks	properNoun
Aner	Anner	properNoun
Vondra	Vondra	properNoun
Oytun	Oytun	properNoun
Ceylan	Ceylan	properNoun
Amel	Amel	properNoun
Theofanis	Theofanis	properNoun
Makarska	Makarska	properNoun
Sutej	Stettej	properNoun
finish seeing	finir de voir	properNoun
Mimoza	Mimoza	properNoun
Erdik	Erdik	properNoun
Plakalovic	Plakalovic	properNoun
Agos	Agos	properNoun
Sagra	Sagra	properNoun
Camdzic	Camdzic	properNoun
Mehta	Mehta	properNoun
Goranko	Goranko	properNoun
Bujar	Bujar	properNoun
Ruganovic	Ruganovic	properNoun
Polyzos	Polyzos	properNoun
Sofia Echo	Sofia Echo	properNoun
Konjic	Konjic	properNoun
Dacian	Dacien	properNoun
Ora	Ora	properNoun
Emmanouil	Emmanouil	properNoun
Kopaonik	Kopaonik	properNoun
Oikonomides	Oiphomides	properNoun
Sasi	Sasi	properNoun
Vodopija	Vodopija	properNoun
Badrov	Badrov	properNoun
Lellouche	Lellouche	properNoun
Sogor	Sogor	properNoun
Komorowski	Komorowski	properNoun
Parisi	Parisi	properNoun
Regas	Régas	properNoun
Edelman	Edelman	properNoun
Fimi	Fimi	properNoun
Sibiu	Sibiu	properNoun
Sidni	Sidni	properNoun
Arnaudija	Arnauja	properNoun
Tumer	Tumeur	properNoun
Tokushukai	Tokushukai	properNoun
Pakrac	Pakrac	properNoun
Der	der	properNoun
Borislav	Borislav	properNoun
Hoyt	Hoyt	properNoun
Chakra	Chakra	properNoun
Vasluianu	Vasluianu	properNoun
Ballhaus	Ballhaus	properNoun
Martinovski	Martinovski	properNoun
Ivantsov	Ivantsov	properNoun
Basyurt	Basyurt	properNoun
Kahiasvilis	Kahiasvilis	properNoun
Polenakovic	Polénakovic	properNoun
Cornel	Cornel	properNoun
Earhart	Écouteur	properNoun
Rehhagel	Rehagel	properNoun
Georgiana	Georgiana	properNoun
Surgutneftgas	Surgutneftegas	properNoun
Huntsman	le chasseur	noun
Huntsman	Chasseur	None
Vozikis	Vozikis	properNoun
Milanko	Milanko	properNoun
Alema	Alumin	properNoun
Generalturist	Généraliste	properNoun
Optima	Optima	properNoun
Raifa	Raifa	properNoun
Trandafir	Trandafir	properNoun
Srna	Srna	properNoun
Avdil	Aviaire	properNoun
Artan	Artan	properNoun
Waldner	Waldner	properNoun
Inamoto	Inamoto	properNoun
Pogea	Pogea	properNoun
Picula	Picula	properNoun
Mungiu	Mungiu	properNoun
Ibo	Ibo	properNoun
Mizsei	Mizei	properNoun
Ekrem	Ekrem	properNoun
Kurveles	Kurve	properNoun
Mitrova	Mitrova	properNoun
Oradea	Oradea	properNoun
Babaje	Babaje	properNoun
Sola	Sola	properNoun
Kozlevo	Kozlevo	properNoun
Cianchetti	Cianchetti	properNoun
benefit from	bénéficier de	properNoun
Roganovic	Roganovic	properNoun
Belane	Croyance	properNoun
Adjami	Adjami	properNoun
Behbahani	Behbahani	properNoun
Picelj	Picelj	properNoun
Morningstar	L'étoile du matin	properNoun
Wesselman	Wesselman	properNoun
Kalinka	Kalinka	properNoun
Golubovci	Golubovci	properNoun
Kyllini	Kyllini	properNoun
Sostan	Sostan	properNoun
Poslovne	Poslovne	properNoun
Gena	Gena	properNoun
Kristic	Krisiste	properNoun
Sevojno	Sevojno	properNoun
Zarubezhneft	Zarubezhneft	properNoun
Cuke	Cuke	properNoun
Sulong	Sous-...	properNoun
Super	formidable	adjective
Super	supérieur	adjective
Super	génial	adjective
Super	sensationnel	adjective
Super	le carburant super	noun
Super	super	None
Kismet	Kismet	properNoun
Hendricks	Hendricks	properNoun
Anoixis	Anoixis	properNoun
Stambolis	Stambolis	properNoun
Darja	Darja	properNoun
Zijadin	Zijadin	properNoun
Savas	Savas	properNoun
Kukan	Kukan	properNoun
Delvina	Delvina	properNoun
Maajka	Maajka	properNoun
Sian	Sian	properNoun
Morosini	Morosini	properNoun
Levadiakos	Levadiakos	properNoun
Sijka	Sijka	properNoun
Bhadrakumar	Bhadrakumar	properNoun
Radosevic	Radosevic	properNoun
Sve	Baisser	properNoun
Lovrin	Lovrin	properNoun
Denktash	Denktash	properNoun
Danev	Danev	properNoun
Carkilovic	Carkilovic	properNoun
Ilium	l' ilion	noun
Ilium	Ilion	None
Tamhein	Tamhein	properNoun
Kleçkë	Kleçkë	properNoun
Adris	Adris	properNoun
Durgun	Durgun	properNoun
Projektomontasa	Projektomontasa	properNoun
Matovinovic	Matovinovic	properNoun
Serkan	Serkan	properNoun
Aland	Un terrain	properNoun
Telfor	Telfor	properNoun
Dimou	Grincheux	properNoun
Kyuns	Kyuns	properNoun
gendarmerie	la gendarmerie	noun
gendarmerie	gendarmerie	None
Buharal	Buharal	properNoun
Ahmen	Ahmen	properNoun
Tasos	Tasses	properNoun
Espace	Espace	properNoun
Mirjana	Mirjana	properNoun
SharrCem	Shardrcem	properNoun
Melone	Mélone	properNoun
Ebart	Ébouriffer	properNoun
Ovnak	Ovnak	properNoun
Grunert	Grunt	properNoun
Lex	Lex	properNoun
Veleka	Veleka	properNoun
Curtea	Corder	properNoun
Malroux	Maltroux	properNoun
Casule	Casule	properNoun
Demetrios	Démétrage	properNoun
Nenova	Nenova	properNoun
Mazare	Mazare	properNoun
Shenol	Shenol	properNoun
Lahmar	Lahmar	properNoun
Gara	Gara	properNoun
Vorgucic	Vorgucique	properNoun
Docovska	Docovska	properNoun
Cerkini	Cerkini	properNoun
SoftLab	Softlab	properNoun
Inaki	Inaki	properNoun
Haracic	Haracique	properNoun
Cenk	Cenk	properNoun
Zmigi	Zmigi	properNoun
Ustaoglu	Ustaoglu	properNoun
Boguslawa	Bêtises	properNoun
Zukorlic	Zukorlique	properNoun
Doyrani	Doyrani	properNoun
Tulpan	Tulpan	properNoun
Paiaziti	Paiaziti	properNoun
Triantaphyllou	Trictaphyllou	properNoun
Bartz	Bartz	properNoun
Kollatos	Kollatos	properNoun
Mumdziju	Mumdziju	properNoun
Sanski	Sanski	properNoun
Beqir	Beqir	properNoun
Moeller	Froneux	properNoun
Elcor	Elcor	properNoun
Aggelopoulos	Aggelopoulos	properNoun
Bolari	Bolari	properNoun
Masterex	Maîtriser	properNoun
Budvanska	Budvanska	properNoun
Fushe	Fush	properNoun
Barisa	Barisa	properNoun
Argyris	Argyris	properNoun
Assan	Assans	properNoun
Rogge	Roggle	properNoun
Chupetanski	Chupéanski	properNoun
Arifhikmet	Arifhikmet	properNoun
Ghervazen	Gerser	properNoun
Krassen	Krassen	properNoun
Kacin	Kacin	properNoun
Milchakova	Milchakova	properNoun
Hamdani	Hamdani	properNoun
Rachida	Rachida	properNoun
Sattinger	Standard	properNoun
Schlagheck	Schlagheck	properNoun
Veran	Veran	properNoun
Medulic	Médullaire	properNoun
Tselepos	Tyspost	properNoun
Gullu	Gullu	properNoun
Arnaut	Arnut	properNoun
Guntepe	Gunte	properNoun
Alsat	Alsat	properNoun
Eventim	Événement	properNoun
Saina	Saina	properNoun
Munk	Munic	properNoun
Bihac	Bihac	properNoun
Istvan	Istvan	properNoun
Seckanovic	Seckanovic	properNoun
Kalmar	Kalmar	properNoun
Pagina	Pagine	properNoun
Belbin	Belbin	properNoun
Bardhim	Bardhim	properNoun
Achilleas	Achilleas	properNoun
Polemao	Polaque	properNoun
Beqai	Beqai	properNoun
Irmak	Irmaque	properNoun
Miloljub	Miloljub	properNoun
Novosti	Novosti	properNoun
Milanka	Milanka	properNoun
Grotius	Grotius	properNoun
Hinriksen	Hinriksen	properNoun
Kildow	Kildow	properNoun
Anastasios	Anastasios	properNoun
Leris	Lérisque	properNoun
Alevis	Alvis	properNoun
Brdjani	Brdjani	properNoun
Ciprian	Ciprian	properNoun
Franjicevic	Franjicevic	properNoun
Enescu	Encucu	properNoun
Burha	Burha	properNoun
Aleksiev	Alekeiev	properNoun
Anri	Anri	properNoun
Borealis	Borealis	properNoun
Petrovo	Petrovo	properNoun
Neamt	Neamt	properNoun
Zadro	Zoadro	properNoun
Soeren	Sale	properNoun
Henig	Henig	properNoun
Sefket	Sefket	properNoun
Katseli	Katseli	properNoun
Pupovci	Pupovci	properNoun
Zlatev	Zlatev	properNoun
Serbs	le serbe	noun
Serbs	Serbe	noun
Serbs	Serbes	None
Reljic	Reljique	properNoun
Fu	Fu	properNoun
Gekas	Gekas	properNoun
Tass	Tass	properNoun
Ilisu	Ilisu	properNoun
Pelagonija	Pelagonija	properNoun
St	saint	abbreviation
St	Style	None
Tafrov	Tafrov	properNoun
Boagiu	Boagiu	properNoun
Coanda	Coanda	properNoun
Cukjati	Cunkjati	properNoun
Zilei	Zilei	properNoun
Ferman	Ferman	properNoun
Svetla	Svetla	properNoun
Artuklu	Artuklu	properNoun
Rakcevic	Rakccep	properNoun
Morfov	Morfondeur	properNoun
Rizaj	Rizaj	properNoun
Retrospectrum	Rétrospectrum	properNoun
Kaludov	Kaludov	properNoun
Kisyov	Kisyov	properNoun
Naji	Naji	properNoun
Zamfirova	Zamfirova	properNoun
Ciobanul	Ciobanul	properNoun
Forminte	Formidable	properNoun
Pabriks	Pabriks	properNoun
smelting	la fonte	noun
smelting	l' extraction par fusion	noun
smelting	fonte	None
Ninova	Ninova	properNoun
Drim	Drim	properNoun
Pia	Pia	properNoun
Holkeri	Holkeri	properNoun
Liangyu	Liangyu	properNoun
Notalik	Notalik	properNoun
Klincov	Klincov	properNoun
Lipjan	Lipjan	properNoun
Desilo	Désilo	properNoun
Stockwell	Stockwell	properNoun
Muasa	Muasa	properNoun
Iovino	Iovino	properNoun
Vojvodinska	Vojvodinska	properNoun
Mileta	Mileta	properNoun
Micus	le mucus	noun
Micus	la mucosité	noun
Micus	Mucus	None
Mrdjen	Mrdjen	properNoun
Kaplanoglu	Kaplanoglu	properNoun
Fabris	Fabriqué	properNoun
HelioBit	Héliobit	properNoun
Burnum	Burnum	properNoun
Dobrivoje	Dobrivoje	properNoun
Citigroup	Citigroup	properNoun
Karolos	Karolos	properNoun
Sucuraj	Sucuraj	properNoun
Godo	Va faire	properNoun
Lambropoulou	Lambropoulou	properNoun
Fleiss	Fuyant	properNoun
Hartmann	Hartmann	properNoun
Feist	Feint	properNoun
Shopov	Shopov	properNoun
Tolgfors	Tolgfors	properNoun
Rudo	Rudo	properNoun
Ozturk	Ozturk	properNoun
Efrossini	Efrossini	properNoun
Ozgen	Ozgen	properNoun
Uertz	Uertz	properNoun
Buyukdeniz	Buyukdeniz	properNoun
Hydro	Hydroélateur	properNoun
Stoa	le stoa	noun
Stoa	Stoa	None
self-determine	auto-déterminer	properNoun
Tanikawa	Tanikawa	properNoun
Skolimowska	Skolimowska	properNoun
Bralic	Bralique	properNoun
Morar	Morar	properNoun
insite	insiter	properNoun
Cojocnean	Cojocnean	properNoun
Selaci	Sélaci	properNoun
Valdete	Valdete	properNoun
Vardarli	Vardarli	properNoun
Steua	Steaua	properNoun
Masonicic	Maçonnique	properNoun
Sabah	Sabah	properNoun
Creanga	Creanga	properNoun
Haydi	Haydi	properNoun
Rit	Rit	properNoun
Miljus	Miljus	properNoun
Alessandri	Alessandri	properNoun
Fedorenko	Fedorenko	properNoun
Trhulj	Trhulj	properNoun
Kolcular	Kolculaire	properNoun
Kistanje	Kistanje	properNoun
Balbay	Balbay	properNoun
Antoci	Antoci	properNoun
Topcider	Topcider	properNoun
Paidika	Padiable	properNoun
Kroi	Kroï	properNoun
Billinis	Billinis	properNoun
Dumitrache	Dumitrache	properNoun
Sahan	Sahan	properNoun
Sicevacka	Sicvacka	properNoun
Helden	Helden	properNoun
Strabag	Strabay	properNoun
Penchev	Penchev	properNoun
Libaridian	Libradian	properNoun
Nesterenko	Nesterenko	properNoun
Siti	Stiti	properNoun
Ooms	Ooms	properNoun
Pektas	Pektas	properNoun
Beobanka	Beobanka	properNoun
Irancell	Irankell	properNoun
Nambaryn	Nambaryn	properNoun
Amoco	Amoco	properNoun
Demirkubuz	Démirkubuz	properNoun
Vijecnica	Vijecnica	properNoun
Oruclu	Oruclé	properNoun
Miliband	Miliband	properNoun
Deskoski	Deskoski	properNoun
Kucukyali	Kucukyali	properNoun
Neroladas	Neroladas	properNoun
Asllanaj	Aslanaj	properNoun
Dardhishta	Dardhishta	properNoun
Arlanda	Arlanda	properNoun
Kurshumli	Kurshumli	properNoun
Tači	Tači	properNoun
Colbo	Colbo	properNoun
Vitous	Vioft	properNoun
Zherka	Zéro	properNoun
Zhivkova	Zhivkova	properNoun
Karadinovic	Karadinovic	properNoun
Dragoti	Dragoti	properNoun
Bajramovski	Bajramovski	properNoun
Prnjavor	Prnjavor	properNoun
Zlatan	Zlatan	properNoun
MediaSind	Médiatique	properNoun
Andrun	Et courir	properNoun
Rukiqi	Rukiqi	properNoun
Pajkic	Pyjkic	properNoun
Kasalovic	Kasalovic	properNoun
Srbica	Srbica	properNoun
Motai	Motai	properNoun
Birtok	Birtok	properNoun
Isufu	Isufu	properNoun
Sorenson	Sorenson	properNoun
Bistra	Bistra	properNoun
Abeylegesse	Abeylegesse	properNoun
Mijac	Mijac	properNoun
Lehliu	Lehliu	properNoun
Doany	Marin	properNoun
Latsia	LATSIA	properNoun
Muharremi	Muhanremi	properNoun
Hisashi	Hisashi	properNoun
Pleiades	les Pléiades	noun
Pleiades	Pléiades	None
Okonjo	Okonjo	properNoun
Bingu	Bingu	properNoun
Daci	Daci	properNoun
Seilliere	Seilliere	properNoun
Antonioni	Antonioni	properNoun
Ramadan	le Ramadan	noun
Ramadan	Ramadan	None
Multi	Multi	properNoun
Tamirjan	Tamirjan	properNoun
Krelja	Krelja	properNoun
Zhur	Zuhr	properNoun
Vejzagic	Vejzagic	properNoun
Skomrahi	Skomrahi	properNoun
Buzek	Buzek	properNoun
Mihic	Mihic	properNoun
Konstantinidis	Konstantinidis	properNoun
Kouvelis	Kouvelis	properNoun
Cotard	Cocard	properNoun
Celebija	Celebija	properNoun
Barts	Bart	properNoun
Radinka	Radinka	properNoun
Gradimir	Gradimir	properNoun
Shqiptare	Shqiptare	properNoun
Srbolek	Srbolek	properNoun
Sharaku	Sharaku	properNoun
Calyon	Calyon	properNoun
Chento	Chento	properNoun
Vacaroiu	Vacaoiu	properNoun
Purda	Puda	properNoun
Mizelle	Mizelle	properNoun
Loftus	Loftus	properNoun
Rizanur	Rizanur	properNoun
Lasko	Lasko	properNoun
Avramopoulos	Avramopoulos	properNoun
Miljko	Miljko	properNoun
Beara	Beara	properNoun
Porumboiu	Porumboiu	properNoun
Suceava	Suceava	properNoun
Mikheil	Mikheil	properNoun
Kavathas	Kavathas	properNoun
Livia	Livia	properNoun
Eralp	Eralp	properNoun
Zorana	Zorana	properNoun
Ignazhden	Ignazhden	properNoun
Lissovlik	Lissovlik	properNoun
Hadzo	Hadzo	properNoun
Franak	Franc	properNoun
Vitakut	Vitakut	properNoun
Barka	Baby	properNoun
Maynooth	De mays	properNoun
Liempde	Liempde	properNoun
Vassiliadou	Vassiliadou	properNoun
Rafis	Rafi	properNoun
Urfa	Urfa	properNoun
Arberia	Arbreia	properNoun
Deree	Déreter	properNoun
Kalyviotis	Kalyviotis	properNoun
Bobova	Bobova	properNoun
Pellum	Pellique	properNoun
Hekal	Hekal	properNoun
Cilipi	Cilipi	properNoun
Ibbotson	Ibbotson	properNoun
Vazov	Vazov	properNoun
Strohal	Strohal	properNoun
Bote	Bosse	properNoun
Dubyna	Dubyna	properNoun
Patzaichin	Patzaichin	properNoun
Bijaca	Bijaca	properNoun
Sunni	Sunni	properNoun
Ostreni	Ostreni	properNoun
Memica	Memica	properNoun
Akay	Akay	properNoun
Vitelloni	Vitelloni	properNoun
Huruglica	Hurruglica	properNoun
Longher	Longe	properNoun
Ruggeri	Ruggeri	properNoun
Zrak	Zrak	properNoun
LukOil	Lukoil	properNoun
Zmajecki	Zmajecki	properNoun
Bayshori	Bayshori	properNoun
Vogt	Vogt	properNoun
Darehshori	Derehshori	properNoun
Gorusen	Gorusen	properNoun
Dalibor	Dalibor	properNoun
Mamula	Mamie	properNoun
Ceren	Céren	properNoun
Potocari	Potocari	properNoun
Massu	Massou	properNoun
Ranga	Ranga	properNoun
Rosatom	Rosatom	properNoun
Nesha	Nesha	properNoun
Fethiye	Féthiye	properNoun
Bolocan	Bolocan	properNoun
Lulzim	Lulzim	properNoun
Asenovgrad	Asenovgrad	properNoun
Duljaj	Duljaj	properNoun
Klassa	Klassa	properNoun
Pyrsos	Pyrsos	properNoun
Schaeffler	Schaeffler	properNoun
Ajai	Ajai	properNoun
Batajnica	Batajnica	properNoun
Sitnesi	Sitnesi	properNoun
Atanasiu	Atanasiu	properNoun
Geshtakovska	Geshtakovska	properNoun
Babayev	Babayev	properNoun
Lolic	Lolique	properNoun
Wprost	Wprot	properNoun
Sajmir	Sajmir	properNoun
Majcen	Majcen	properNoun
Basara	Basara	properNoun
Manev	Manev	properNoun
Govedarska	Goduvearska	properNoun
Amedeo	Amedo	properNoun
Mugosa	Mugosa	properNoun
Castorf	Castorf	properNoun
Intrasoft	Intrasoft	properNoun
Bigley	Bigley	properNoun
Espot	Espot	properNoun
Repishti	Repishti	properNoun
Vlasinka	Vlasinka	properNoun
Bruner	Bruneur	properNoun
Loverdos	Loverdos	properNoun
Veselin	Veselin	properNoun
Mogao	Mogao	properNoun
Brasov	Brasov	properNoun
Manda	Manda	properNoun
Gryzlov	Gryzlov	properNoun
Velinov	Velinov	properNoun
Sreten	Sréten	properNoun
Greceanii	Greceanii	properNoun
Harbuz	Habuz	properNoun
Malici	Malici	properNoun
Fawzi	Fawzi	properNoun
Kiselina	Kiselina	properNoun
Chepintsi	Chépintsi	properNoun
Hurriet	Hurriyet	properNoun
Winterstein	Winterstein	properNoun
Mando	Mandat	properNoun
Manea	Manier	properNoun
Petrovden	Petrovène	properNoun
Balukovs	Balukovs	properNoun
Dalekovod	Dalekovod	properNoun
Berlinale	Berlinale	properNoun
Abdulrahman	Abdulrahman	properNoun
Haris	Harris	properNoun
Hajduk	Hajduk	properNoun
Rycroft	Rycroft	properNoun
Aristeidis	Aristeidis	properNoun
Ereli	Ereli	properNoun
Blaga	Blaga	properNoun
Petsos	Petsos	properNoun
Talita	Talita	properNoun
Scola	Scola	properNoun
Samsunspor	Samsunspor	properNoun
Ilter	Ilter	properNoun
Trajkova	Trajkova	properNoun
Laiki	Laiki	properNoun
Lilongwe	Lilongwe	properNoun
Puturus	Puture	properNoun
Vima	Vima	properNoun
Ruzhin	Ruzhin	properNoun
Tsarouhas	Tsarouhas	properNoun
Tzvetina	Tzvetina	properNoun
Pamuk	Pamuk	properNoun
Nejat	Nejat	properNoun
Pincom	Pincement	properNoun
be at war	être en guerre	properNoun
Gaco	Gaco	properNoun
Madra	Madra	properNoun
McCurdy	McCurdy	properNoun
Moghadam	Moghadam	properNoun
intensivise	intensifier	properNoun
Shushelov	Shushelov	properNoun
Kozljak	Kozljak	properNoun
Teleskovic	Téleskovic	properNoun
Loncar	Loncar	properNoun
Gazmir	Gamanier	properNoun
Borisova	Borisova	properNoun
Sekularac	Sekularac	properNoun
Ozgur	Ozgur	properNoun
Curuvija	Curuvija	properNoun
Oscarson	Oscarson	properNoun
Sportske	Piste	properNoun
Ismailati	Ismailati	properNoun
Salih	Salih	properNoun
Phanar	Phanar	properNoun
de	de	properNoun
Blazic	Blazique	properNoun
Melk	Melette	properNoun
Klatsias	Klaatsias	properNoun
Baki	Baki	properNoun
ArcelorMittal	ArcelorMittal	properNoun
Eftimov	Eftimov	properNoun
Narancic	Narancique	properNoun
Sanofi	Sanofi	properNoun
Kasahu	Kasahu	properNoun
Marcie	Marcade	properNoun
Verso	le verso	noun
Verso	Verso	None
Ulkin	Ulkin	properNoun
Pavlaki	Pavlaki	properNoun
Blaurock	Blague	properNoun
Konjikusic	Konjikusic	properNoun
Tatjana	Tatjana	properNoun
Gulfidan	Gulfidan	properNoun
Kriti	Kriti	properNoun
Antun	Antun	properNoun
Chaushev	Chaushev	properNoun
Paganini	Paganini	properNoun
Pleskonic	Pleskonique	properNoun
Uzak	Uzak	properNoun
Baa	Bêlement	properNoun
Nuta	Noi	properNoun
Ergys	Ergys	properNoun
Clicknet	Clicknet	properNoun
Sagor	Sagor	properNoun
Gavazi	Gavazi	properNoun
Panagyurishte	Panagyurishte	properNoun
Besnik	Besnik	properNoun
Shaza	Shaza	properNoun
Brac	Bracelet	properNoun
Papastathopoulos	PapasTathopoulos	properNoun
Derilova	Derilova	properNoun
Dogubayazit	Dogubayazit	properNoun
Bialystok	Biaystsok	properNoun
Byman	Byman	properNoun
Salamun	Salamun	properNoun
Sibiului	Sibiului	properNoun
Dolichenus	Dolichenus	properNoun
Mullen	Mullen	properNoun
Mikra	Mikra	properNoun
Skaramuca	Skarramuca	properNoun
Meliha	Meliha	properNoun
Ayca	Ayca	properNoun
Trebinje	Trebinje	properNoun
Tursinovic	Tursinovic	properNoun
Markopoulo	Markopoulo	properNoun
Kozjak	Kozjak	properNoun
Cartan	Cartan	properNoun
Amstel	Amstel	properNoun
Cerrahpasa	Cerrahpasa	properNoun
Breivik	Breivik	properNoun
Ramaz	Ramaz	properNoun
Efeer	Efeer	properNoun
Rilkovski	Rilkovski	properNoun
Bondarenko	Bondarenko	properNoun
Pasaoglu	Pasaoglu	properNoun
Kosuta	Kosuta	properNoun
Italiano	Italien	properNoun
Stara Zagora	Stara Zagora	properNoun
Bodiu	Bodiu	properNoun
Borgata	Borgata	properNoun
Krenar	Krenar	properNoun
Melih	Melih	properNoun
Aleksandar	Aleksandar	properNoun
Plese	Plie	properNoun
Mahala	Mahala	properNoun
Handelsblad	HandelsBlad	properNoun
Velo	Velo	properNoun
Tupras	Tupras	properNoun
Sumerbank	Summerbank	properNoun
Icenet	Icénècheur	properNoun
Lutovac	Lutovac	properNoun
Luma	Luma	properNoun
Volandri	Volandri	properNoun
Reme	Remonter	properNoun
Zehra	Zehra	properNoun
Raichev	Raichev	properNoun
Allianoi	Allianoi	properNoun
Mukesh	Muqueux	properNoun
Onsekiz	Tinser	properNoun
Gemax	Gemax	properNoun
Zana	Zana	properNoun
Barakovac	Barakovac	properNoun
Peštera	Peinture	properNoun
Katinka	Katinka	properNoun
Partos	Partos	properNoun
Dragetta	Dragetta	properNoun
Poenaru	Poenaru	properNoun
Rtari	Rti	properNoun
Noric	Nordique	properNoun
Bulbank	Bulbanque	properNoun
Dudi	Dudi	properNoun
Davitkovski	Davitkovski	properNoun
Lissovolik	Lissovolik	properNoun
Usaki	Usaki	properNoun
Ducaru	Ducaru	properNoun
Stevica	Stevica	properNoun
Zmaj	Zmaj	properNoun
Nasaud	Nasaud	properNoun
Piraeus	Piraeus	properNoun
Karadag	Karadag	properNoun
Hortefeux	Hortefeux	properNoun
Dendias	Dendias	properNoun
Iti	ITI	properNoun
Redzepova	Redzepova	properNoun
Ersonmez	Ersonmez	properNoun
Lutvikadic	Lutvikadique	properNoun
Irimescu	Irilscu	properNoun
Fundacao	Fundacao	properNoun
Mioc	Mioc	properNoun
Sitilides	Sittias	properNoun
Sitton	Sitton	properNoun
Melnik	Melnik	properNoun
Ilaz	Ilaz	properNoun
Stratos	Stratos	properNoun
Gledis	Gladias	properNoun
Veskova	Veskova	properNoun
Dum	Monstre	properNoun
Rogachev	Rogachev	properNoun
Gerdjikov	Gerdjikov	properNoun
Spiliotopoulos	SpilioTopoulos	properNoun
Kerincsiz	Kerincsiz	properNoun
Kuk	Kuk	properNoun
Isner	Isner	properNoun
Nordeen	Norden	properNoun
Paroubek	Paroubek	properNoun
Bundesrat	Bundesrat	properNoun
Karov	Karov	properNoun
Gligorijevic	Gligorijevic	properNoun
Obretenov	Obtreenov	properNoun
Titanick	Titanick	properNoun
Menekse	Menekse	properNoun
Senjak	Senjak	properNoun
Bulutogullari	Bulutogullari	properNoun
Belene	Belene	properNoun
Tahire	Tahire	properNoun
Caliskan	Caliskan	properNoun
Monajed	Monajed	properNoun
Zivan	Zivan	properNoun
Karaula	Karaula	properNoun
Myftaraj	Myftarataj	properNoun
Debene	Débenuer	properNoun
Burmali	Burmali	properNoun
Taibah	Tabah	properNoun
Ilhan	Ilhan	properNoun
Piersic	De Piersic	properNoun
Transconflict	Transconnier	properNoun
Antena	Antena	properNoun
Todorov	Todorov	properNoun
Tiesto	Tiesto	properNoun
Nkwonta	Nkwonta	properNoun
Dalmatina	Dalmatina	properNoun
Zelal	Zélalique	properNoun
Clerides	Clériceurs	properNoun
Shishmanova	Shishmanova	properNoun
Vaksince	Vaksince	properNoun
Foniqi	Foniqi	properNoun
Slanchev	Slanchev	properNoun
Las	Las!	interjection
Las	Las	None
Germanwings	Germanwings	properNoun
Euroil	Onomer	properNoun
Medgidia	Médgidies	properNoun
Komercni	Komercni	properNoun
Vassileiou	Vassileiou	properNoun
Espana	Espana	properNoun
Vesic	Vésique	properNoun
Komarnica	Komarnica	properNoun
Lozanova	Lozanova	properNoun
Evgeniy	Evgeniy	properNoun
Radja	Radja	properNoun
Haradin	Haradin	properNoun
Zikol	Zikol	properNoun
bring in	apporter	properNoun
Stanonik	Stanonik	properNoun
Volkan	Volkan	properNoun
Keqa	Keqa	properNoun
Gorazdevac	Gorazdevac	properNoun
Gorbis	Gorbis	properNoun
Fronius	Fronius	properNoun
Ozbilgin	Ozbilidu	properNoun
Donchev	Donchev	properNoun
Woodrow	Woodrow	properNoun
Belopeta	Bélopeta	properNoun
Spyropoulos	Spyropoulos	properNoun
Scampa	Scampa	properNoun
Miklavcic	Miklavcic	properNoun
Župljanin	Župljanin	properNoun
Zahariev	Zahariev	properNoun
Milevska	Milevska	properNoun
Vrljic	Vrljic	properNoun
Lesar	Lesar	properNoun
Er	Er	properNoun
Diamantopoulou	Diamantopoulou	properNoun
Mlinsek	Mignonner	properNoun
Trkulja	Trkulja	properNoun
Irine	Ironique	properNoun
Esmer	Esmer	properNoun
Rumyana	Rumyana	properNoun
Cibona	Cibona	properNoun
Peltecu	Peltecu	properNoun
Hasret	Hasret	properNoun
Astrolavos	Astrolavos	properNoun
Feller	Feller	properNoun
Benko	Benko	properNoun
Aeschylia	AESCHYLUS	properNoun
Ait	la petite île	noun
Ait	le fardeau	noun
Ait	Audit	None
Lambrinidis	Lambrinidis	properNoun
Geza	Geza	properNoun
Tsatoumas	Tsatoumas	properNoun
Feodor	Feodor	properNoun
Eurotransplant	Eurotransplant	properNoun
Omisalj	Omisalj	properNoun
Ejup	Ejup	properNoun
Krueger	Krueger	properNoun
Lawler	Juriste	properNoun
Bernanke	Bernanke	properNoun
Mouskouri	Mouskouri	properNoun
Fterolaka	Fterolaka	properNoun
Ohlson	Ohlson	properNoun
Panithinaikos	Pancathinaïkos	properNoun
Pandelina	Pandelina	properNoun
Dragin	tenir à placer	verb
Dragin	Dragin	None
Turija	Turija	properNoun
Koukouvinou	Koukouvinou	properNoun
Trasha	Trash	properNoun
Ulza	Ulza	properNoun
Medecur	Mec	properNoun
Mediocredito	Médiocrediato	properNoun
Ciovo	Ciovo	properNoun
Lipka	Lipka	properNoun
Beton	Beton	properNoun
Trezor	Trezor	properNoun
Halonen	Halonen	properNoun
Zine	Zine	properNoun
Socotab	Socotab	properNoun
Pojar	Pojar	properNoun
Matijak	Matijak	properNoun
Peeva	Peeva	properNoun
Balestra	Balestra	properNoun
Haiden	Hainé	properNoun
Gobekli	Gobekli	properNoun
Hof	Hof	properNoun
Petricevac	Petricevac	properNoun
Synode	Se synchir	properNoun
Ertl	Ertl	properNoun
Albtelecom	Albelecom	properNoun
Arinc	Arinc	properNoun
Tokyay	Tokkyay	properNoun
Giscard	Giscard	properNoun
Konicek	Konicek	properNoun
Nanae	Nana	properNoun
Vllahiu	Vllahiu	properNoun
Sitia	Sitia	properNoun
Stratfor	Strat	properNoun
Borislava	Borislava	properNoun
Castells	Castells	properNoun
Anyu	AnyU	properNoun
Rosalyn	Rosalyn	properNoun
Tancevova	Tantvova	properNoun
Varnum	Vernis	properNoun
Gilauri	Gilauri	properNoun
Samartini	Sammartini	properNoun
Gercek	Gercek	properNoun
Gajic	Gajic	properNoun
Dadfar	Dadfar	properNoun
wait for	attendre	verb
wait for	attendre	None
Plugchieva	Planchieva	properNoun
Gogu	Gogu	properNoun
Cohu	Cohu	properNoun
Tuori	Tuori	properNoun
Vrbanja	Vrbanja	properNoun
Medresa	Medresa	properNoun
Dashnim	Dashnim	properNoun
Pepa	Pepa	properNoun
Schinoussa	Schinousse	properNoun
Karapetric	Karapétrique	properNoun
Rief	Faire	properNoun
Ruhi	Ruhi	properNoun
Haramain	Haramain	properNoun
Calif	Calif	properNoun
Mamusa	Mamusa	properNoun
Habur	Habur	properNoun
Cajavec	Cajavec	properNoun
Ragmi	Ragmi	properNoun
Sime	Coup	properNoun
Bau	Baau	properNoun
Fuerzas	Fuerzas	properNoun
Latsis	Latsis	properNoun
Dosso	Dosso	properNoun
Mekanigiev	Mekanigiev	properNoun
Turhan	Turhan	properNoun
Geraads	Gaads	properNoun
Canaj	Canaj	properNoun
Pacuraru	Pacuraru	properNoun
Marchev	Marchev	properNoun
Huizinga	Huizinga	properNoun
Petin	Pétin	properNoun
Hayrudin	Hayruch	properNoun
Nafplio	Nafplio	properNoun
Husejnefendi	Husejnefendi	properNoun
Hartke	Hartke	properNoun
Ceyda	Ceyda	properNoun
Markovska	Markovska	properNoun
GloBul	Globul	properNoun
Novicki	Novicki	properNoun
Zeljezara	Zeljezara	properNoun
Zukovic	Zukovic	properNoun
Karadzhova	Karadzhova	properNoun
Egeresi	Egeresi	properNoun
Vasilika	Vasilika	properNoun
Ayache	Ayache	properNoun
Omnia	Omnia	properNoun
Kadiev	Kadiev	properNoun
Mujaj	Mujaj	properNoun
Ercin	Ercin	properNoun
Delijorgji	Délijorgji	properNoun
Zakumi	Zakumi	properNoun
Ted	faner	verb
Ted	Tad	None
Cullufi	Cullufi	properNoun
Pepene	Peintre	properNoun
Gudenoge	Gudenoge	properNoun
Tarlev	Tarlev	properNoun
Ducic	Ducic	properNoun
Semov	Smoord	properNoun
Podujevo	Podujevo	properNoun
Orestis	Orestis	properNoun
Paavo	Paavo	properNoun
Sorkocevic	Skorkocevic	properNoun
Bucay	Bucay	properNoun
Sadak	Sadak	properNoun
Piristina	Piristina	properNoun
Kruljac	Kruljac	properNoun
Saif	Saif	properNoun
Vyntra	Vyntra	properNoun
Bernie	Bernie	properNoun
Devrient	Déviant	properNoun
Sallaku	Sallaku	properNoun
Ayhan	Ayhan	properNoun
Arben	Arben	properNoun
Inzko	Inzko	properNoun
Valton	Valton	properNoun
Atasehir	Atasehir	properNoun
Estadent	Estadent	properNoun
Gashi	Gashi	properNoun
Bulku	Bulku	properNoun
Ivet	Ivette	properNoun
Iktisat	Iktisat	properNoun
Boitor	Idiot	properNoun
Lismar	Lismar	properNoun
Sestic	Sale	properNoun
Ales	Alès	properNoun
Netkov	Netkov	properNoun
Shehovic	Shehovic	properNoun
Kaloshi	Kaloshi	properNoun
Kolo	Kolo	properNoun
Behlul	Behlul	properNoun
Comeaga	Comeaga	properNoun
Koufondinas	Koufontinas	properNoun
Cosmote	Cosmote	properNoun
Vuco	Vuco	properNoun
Arsim	Arrsim	properNoun
Milica	Milica	properNoun
Steg	Tig	properNoun
Botsan	Botte	properNoun
Skurev	Skurev	properNoun
Kastriot	Kastriot	properNoun
Ahtisaari	Ahtisaari	properNoun
Montagnier	Montagnier	properNoun
Vagiani	Vagiani	properNoun
Decan	Décan	properNoun
Palli	Palli	properNoun
Seim	Seigneur	properNoun
Dov	Débutant	properNoun
Asiel	Asiel	properNoun
Grcar	Grincard	properNoun
Miculescu	Microscu	properNoun
Mkrtchyan	Mkrtchyan	properNoun
Erjon	Erjon	properNoun
Delavekouras	Delavekouras	properNoun
Diakoumis	Diamoumis	properNoun
Budina	Boudin	properNoun
Piccoti	Piccoti	properNoun
Pevtsaev	Pevtsaev	properNoun
Telem	Télémémération	properNoun
Valadria	Valadria	properNoun
Teuta	Teuta	properNoun
Cernauteanu	Cernauteanu	properNoun
Tarfa	Tarfa	properNoun
Tisno	Tisno	properNoun
Mema	Mema	properNoun
Georgian	géorgien	adjective
Georgian	Géorgien	None
Tayyar	Tayyar	properNoun
Hamanov	Hamanov	properNoun
Musliu	Musullu	properNoun
Klopka	Klopka	properNoun
Verbeke	Verbeke	properNoun
Karamehmet	Karamehmet	properNoun
Vincetic	Vigoureux	properNoun
Kazanlak	Kazanlak	properNoun
Matsurine	Matsurine	properNoun
Fandakova	Fandakova	properNoun
Loteska	LOTESKA	properNoun
Diaconu	Diacot	properNoun
Cati	Cati	properNoun
Alf	Alf	properNoun
Evriveavis	Evrivevis	properNoun
Argyrakis	Argyracis	properNoun
Tsubota	Tsubota	properNoun
Kutay	Kutay	properNoun
Prelog	Prorogènes	properNoun
Dimitrija	Dimitrija	properNoun
Igas	Igas	properNoun
Finci	Finci	properNoun
Berdynaj	Berdynaj	properNoun
Straits	la gêne	noun
Straits	las situation difficile	noun
Straits	Détroit	None
Parallels	parallèle	noun
Parallels	l' analogue	noun
Parallels	être parallèle	verb
Parallels	être parallèle à	verb
Parallels	établir un parallèle entre	verb
Parallels	être analogue à	verb
Parallels	faire un parallèle entre	verb
Parallels	Parallèles	None
Sighisoara	Sighisoara	properNoun
Sokoli	Sokoli	properNoun
Krlezin	Krlezin	properNoun
Dionisie	Dionisie	properNoun
Stefanini	Stefanini	properNoun
Martonyi	Martéoni	properNoun
Genjac	Genjac	properNoun
Pesa	Pesa	properNoun
Maka	Maka	properNoun
Mogoshoaiei	Mogoshoaiiei	properNoun
Pagu	Pagu	properNoun
Kariye	Kariye	properNoun
Cvjeticanin	Cvjeticanine	properNoun
Eckhard	Eckhard	properNoun
Nazli	Nazli	properNoun
Bozov	Bozov	properNoun
Aynur	Aynur	properNoun
Informatika	Informatika	properNoun
Kerco	Kerco	properNoun
Zeravcic	Zéravacique	properNoun
Ekinci	Ekinci	properNoun
Trivo	Trivo	properNoun
Lambe	Lambeau	properNoun
Eurostandard	Eurostandard	properNoun
apart from	en dehors de	preposition
apart from	sauf	preposition
apart from	hors	preposition
apart from	excepté	preposition
apart from	outre que	preposition
apart from	hormis que	preposition
apart from	à l'écart de	preposition
apart from	si ce n'est	preposition
apart from	Excepté	None
Matova	Matova	properNoun
Thanou	Thanou	properNoun
Vatan	Vatan	properNoun
Kocak	Kocak	properNoun
Ilija	Ilija	properNoun
Bise	Bison	properNoun
Brangelina	Brangelina	properNoun
Daglas	Diglas	properNoun
Kifissos	Kifissos	properNoun
Selmani	Selmani	properNoun
Tepelene	Teepelene	properNoun
Blackwell	Blackwell	properNoun
Zepce	Zepce	properNoun
Seko	Seko	properNoun
Burim	Burim	properNoun
Petrac	Pétrolier	properNoun
Sazdova	Sazdova	properNoun
Casuneanu	Casuneanu	properNoun
Radoncic	Radoncique	properNoun
causing	provoquant	properNoun
Blagas	Blagas	properNoun
Svetlin	Svetlin	properNoun
Charilaos	Charilaos	properNoun
Apoxyomenos	Apoxyomenos	properNoun
Selgros	Selgros	properNoun
Storck	Scandale	properNoun
Saposnikov	Saposnikov	properNoun
Zlatku	Zlatku	properNoun
Grabovac	Grabovac	properNoun
Umoljan	Umoljan	properNoun
Enpower	Renforcer	properNoun
Tomov	Tomov	properNoun
Stinga	Ska	properNoun
Kockice	Kockice	properNoun
Taraf	Taraf	properNoun
Zirje	Zirje	properNoun
Trstenik	TRSTENIK	properNoun
Medvegje	Medvegje	properNoun
Artvin	Artvin	properNoun
Alkaios	Alcaios	properNoun
Jashar	Jashar	properNoun
Tzvetozar	Tsvetozar	properNoun
Monmartre	Montmartre	properNoun
Marnhac	Marnhac	properNoun
Simioni	Simioni	properNoun
Gheit	Gheit	properNoun
Mastrogeorgio	Mastrogeorgio	properNoun
Rompuy	Rompuy	properNoun
Mika	Mika	properNoun
Osmani	Osmani	properNoun
Brijuni	Brijuni	properNoun
Transdniester	Transdnier	properNoun
Sicko	Sicko	properNoun
Emfesz	Emfesz	properNoun
build on	Construire	properNoun
Patrut	Banlieue	properNoun
Cizelj	Cizelj	properNoun
Behcet	Behake	properNoun
Markulova	Markulova	properNoun
Isailovic	Isailovic	properNoun
Subota	Suboter	properNoun
Brashori	Brashori	properNoun
Etar	Étar	properNoun
Suppan	Supplier	properNoun
Leposava	Leposava	properNoun
Sethstat	Séthstat	properNoun
Tihomir	Séthstat	properNoun
Viotia	Viotia	properNoun
Evliyaoglu	Evliyaoglu	properNoun
Hidrogradnja	Hidrogradnja	properNoun
Lorenc	Lorenc	properNoun
Astroturf	Astroturf	properNoun
Evenimentul	Gilettul	properNoun
Riccobono	Riccobono	properNoun
Maharramov	Maharramov	properNoun
Wang	Wang	properNoun
Zacharo	Zacharo	properNoun
Kostolac	Kostolac	properNoun
Kut	Kut	properNoun
Hayati	Hayati	properNoun
Mikan	Mikan	properNoun
Ivor	Ivoir	properNoun
Cicmil	Cicil	properNoun
Cocaj	Cocaj	properNoun
Skiada	Skiada	properNoun
Aynali	Aynnali	properNoun
Pinocchio	Pinocchio	properNoun
Trajanka	Trajugé	properNoun
Buxhala	Biphala	properNoun
Rozaje	Rozaje	properNoun
Dreiski	Dreiski	properNoun
Kanyon	Kanyon	properNoun
Terterov	Terterov	properNoun
Dossi	Dossi	properNoun
Molivjatis	Molivjatis	properNoun
Stavrolimenas	Stavrolimenas	properNoun
Mikhalovich	Mikhalovich	properNoun
Sukarova	Sukarova	properNoun
Fagaras	Fagaras	properNoun
Kotorsko	Kotorsko	properNoun
Ozan	Ozan	properNoun
Erdman	Erdman	properNoun
Cercavschi	Cercavschi	properNoun
Cair	Care	properNoun
Trendafilov	Trendafilov	properNoun
Miljevac	Miljevac	properNoun
Gerdec	Gerdec	properNoun
Nudzeim	Nudzeim	properNoun
Allianz	Allianz	properNoun
Haralambos	Haralambos	properNoun
Sabetta	Sabetta	properNoun
Aceski	Aceski	properNoun
Dinu	Dinu	properNoun
Zofman	Zofman	properNoun
Cadzo	Cadzo	properNoun
Duje	Duje	properNoun
Mayis	Mai est	properNoun
Tezkan	Tezkan	properNoun
Kozani	Kozani	properNoun
Limarev	Limarev	properNoun
Christou	Christou	properNoun
Geziqi	Geziqi	properNoun
Klime	Klime	properNoun
Serdyukov	Serdyukov	properNoun
Gvozdenovici	Gvozdenovic	properNoun
Muhsin	Muhsin	properNoun
Bistrishko	Bistrishko	properNoun
Chalkia	Chalkia	properNoun
Nasiakos	Nasiakos	properNoun
SmartCard	Carte à puce	properNoun
Ikki	Ikki	properNoun
Falovic	Falovic	properNoun
Cyril	Cyril	properNoun
Tusac	Tusac	properNoun
Primal	primitif	adjective
Primal	premier	adjective
Primal	principal	adjective
Primal	des premiers âges	adjective
Primal	Primitif	None
Lulzin	Lulzin	properNoun
Lajmifundit	Lajmifundit	properNoun
Husnu	Handicapé	properNoun
same	même	adjective
same	susdit	adjective
same	même	None
Autovision	Autot	properNoun
Vrhbosanska	Vrhbosanska	properNoun
Marfin	Marfin	properNoun
Vlahusic	Vlahusic	properNoun
Vaslui	Vaslui	properNoun
Srbijanka	Srbijanka	properNoun
Sinanovic	Sinanovic	properNoun
Stefanov	Stefanov	properNoun
Libi	Libi	properNoun
Blominfo	Blominfo	properNoun
Musloglu	Musuloglu	properNoun
Antakya	Antakya	properNoun
Kosaner	Kosaner	properNoun
Devetak	Dévettak	properNoun
Bruette	Bruyette	properNoun
Sportius	Sportif	properNoun
Tieger	Tige	properNoun
Fota	Fota	properNoun
Birnholdz	Birnholz	properNoun
Koci	Koci	properNoun
Aalto	Aalto	properNoun
Hohmann	Hohmann	properNoun
Alistar	Alistare	properNoun
Anusic	Anusique	properNoun
Fahd	Fahd	properNoun
Kociancic	Kociancique	properNoun
Cigli	Cigli	properNoun
Dem	Dem	properNoun
Tsvetan	Tsvetan	properNoun
Behija	Behija	properNoun
Arshavin	Arshavin	properNoun
Inventa	Inventation	properNoun
Vetevendosje	Vetevendosje	properNoun
Rudisha	Rudisha	properNoun
Lamfalussy	Lamfalussy	properNoun
Vlatko	Vlatko	properNoun
Makarios	Makarios	properNoun
Blakaj	Blakaj	properNoun
Krafts	Kraft	properNoun
Gilan	Gilan	properNoun
Sajic	Sajic	properNoun
Lire	Loyer	properNoun
Mareza	MAREZA	properNoun
Zeke	Zéke	properNoun
Zhelyazkov	Zhelyazkov	properNoun
Laver	Laver	properNoun
Rinvest	Rinçait	properNoun
Trumbic	Trumbique	properNoun
Corum	Cormle	properNoun
Riaset	Riee	properNoun
Dragana	Dragana	properNoun
Esma	Esma	properNoun
Ryna	Ryna	properNoun
Hazbi	Hazer	properNoun
Ningbo	Ningbo	properNoun
Eurogroup	Eurogroupe	properNoun
Galiste	Galer	properNoun
Omazic	Omazic	properNoun
Avnoj	Avnoj	properNoun
Panaritis	Panarite	properNoun
Geyde	Geyde	properNoun
Hatipo	Hatipo	properNoun
Moutafis	Mouertafis	properNoun
LegaCoop	Mouertafis	properNoun
Fanche	Folle	properNoun
Lutem	Lutem	properNoun
Tatarlieva	Tatarlieva	properNoun
Kawaguchi	Kawaguchi	properNoun
Strajin	Kawaguchi	properNoun
Izetbegovic	Izetbegovic	properNoun
Arnoume	Arnoume	properNoun
Benes	Benes	properNoun
Sabanis	Sabanis	properNoun
Julliard	Juilliard	properNoun
Qinghong	Qinghong	properNoun
Azotara	Azotara	properNoun
Tamam	Tamam	properNoun
Nistorescu	Nistorescu	properNoun
Gradevinar	Diplômé	properNoun
Turcan	Turcan	properNoun
Zitomislic	Zitomiscique	properNoun
Kandil	Kandil	properNoun
Dhermi	Dhermi	properNoun
Anagnostaras	Anagnostares	properNoun
Zumrut	Zumrut	properNoun
Semjen	Semng	properNoun
Garbunov	Semng	properNoun
Chrome	le chrome	noun
Chrome	Chrome	None
Diyarbakir	Diyarbakir	properNoun
Lipnjak	Lipnjak	properNoun
Drisla	Drisla	properNoun
Veijo	Veijo	properNoun
Cedomir	Cédomir	properNoun
Shqip	Shqip	properNoun
Staljonic	Staljonique	properNoun
Krasniqi	Krasniqi	properNoun
Georgiades	Georgiades	properNoun
Alempijevic	Alempijevic	properNoun
Kratkofil	Kratkofil	properNoun
Fatic	Fatique	properNoun
Rogozin	Rogozin	properNoun
Doci	DOCI	properNoun
Akdas	Akdas	properNoun
Orastie	Orastie	properNoun
Primorac	Primoracieux	properNoun
Kapela	Kapela	properNoun
ArtKontakt	Artkontakt	properNoun
Mirogoj	Mirogoj	properNoun
Solta	Mirogoj	properNoun
Sostra	Sostra	properNoun
Crisu	Cristillant	properNoun
Hajredini	Hajredini	properNoun
Giurgiu	Giurgiu	properNoun
Georganta	Georganta	properNoun
Bab	Babe	properNoun
Fateh	Fateh	properNoun
Delcevo	Delcevo	properNoun
Semir	Semir	properNoun
Dule	Piquant	properNoun
Babalola	Babalola	properNoun
Datuk	Datuk	properNoun
Ude	Ude	properNoun
Barbalic	Baralique	properNoun
Zavidovici	Zavidovici	properNoun
Ortakoy	Ortakoy	properNoun
Suharoschi	Suharoschi	properNoun
Kashahu	Kashahu	properNoun
Trto	TRO	properNoun
Tadzudin	Tadzudin	properNoun
Konut	Konut	properNoun
Trajanov	Trajanov	properNoun
Pampuri	Pampurri	properNoun
Inacio	Inacio	properNoun
Feridun	Feridifier	properNoun
Bostinaru	Bostinaru	properNoun
Ramulic	Radmanique	properNoun
Litra	LITRA	properNoun
Kallithea	Kallithea	properNoun
Domanovic	Domanovic	properNoun
Silvan	sylvain	adjective
Silvan	Sylvain	None
Tack	clouer	verb
Tack	bâtir	verb
Tack	faufiler	verb
Tack	changer la direction	verb
Tack	essayer une autre tactique	verb
Tack	faire une bordée	verb
Tack	le bord	noun
Tack	la sellerie	noun
Tack	le clou	noun
Tack	la punaise	noun
Tack	la bordée	noun
Tack	la semence	noun
Tack	Clouer	None
Degefa	Dégénéfice	properNoun
Sen	Sen	properNoun
Baskin	s'ensoleiller	verb
Baskin	Baskin	None
Fieschi	Fieschi	properNoun
Galabov	Galabov	properNoun
Chilova	Chilova	properNoun
Pavelescu	Pavelescu	properNoun
Sorescu	Pavelescu	properNoun
Bencomo	Bencomo	properNoun
Atomstroiexport	Atomstroyexport	properNoun
Bine	las fin de série	noun
Bine	Bile	None
Peqani	Peqani	properNoun
Kapianou	Kapianou	properNoun
Mustafic	Musical	properNoun
Biloxi	Biloxi	properNoun
Nikodinovska	Nikodinovska	properNoun
Buljarica	Buljarica	properNoun
hint at	allusion à	properNoun
Semih	Semih	properNoun
Srdoc	Srdoc	properNoun
Ogun	Ogun	properNoun
Dojran	Dojran	properNoun
Sinan	Sinan	properNoun
Lazaros	Lazaros	properNoun
Uma	Uma	properNoun
Cernauti	Cernauti	properNoun
Atanasy	Atanasy	properNoun
Viitorul	Vienitorul	properNoun
Kakrinje	Kakrinje	properNoun
Pond	l' étang	noun
Pond	le bassin	noun
Pond	la mare	noun
Pond	Étang	None
Mulic	Mulique	properNoun
Safeta	Safeta	properNoun
Stylianidis	Stylianidis	properNoun
Kamari	Kamari	properNoun
Damone	Damone	properNoun
Mottaki	Mottaki	properNoun
for a few days	pour quelques jours	properNoun
Vasem	Vasem	properNoun
Oli	Oli	properNoun
Tiriac	Ticriaque	properNoun
Suhareka	Suhareka	properNoun
Leskaj	Leskaj	properNoun
Kusturica	Kusturica	properNoun
Rusheku	Rusheku	properNoun
Genadiy	Genadiy	properNoun
Marjanovic	Marjanovic	properNoun
Spanta	Fantaisie	properNoun
Muntean	Muntean	properNoun
Mamidakis	Mamidakis	properNoun
Cakuli	Cakuli	properNoun
Univerzal	Univerzal	properNoun
Telemachos	Télémachos	properNoun
Remikovic	Remikovic	properNoun
Tusup	Tusup	properNoun
Sinassos	Sinassos	properNoun
Worldcom	Monde	properNoun
Madara	Madara	properNoun
Kosmocell	Kosmocell	properNoun
Vasily	De vaste	properNoun
Liridona	Liridona	properNoun
Mama	la maman	noun
Mama	la mère	noun
Mama	Maman	None
Isil	Isil	properNoun
Usorac	Isil	properNoun
Gueven	Gueven	properNoun
Kucler	Kucleur	properNoun
Jelena	Jelena	properNoun
Melzer	Melzer	properNoun
Perparim	Perparim	properNoun
Pantelija	Pantelija	properNoun
Bekim	Bekim	properNoun
Mollanji	Mollanji	properNoun
Kyriaki	Kyriakie	properNoun
Beopetrol	Beopetrol	properNoun
Daqun	Daqun	properNoun
Teovo	Teovo	properNoun
Coindu	Coindu	properNoun
Kovats	Kovats	properNoun
Guzide	Guzide	properNoun
Drenica	Drenica	properNoun
Fleischer	Fleischer	properNoun
Olinka	Olinka	properNoun
Apostoleanu	Apostoleanu	properNoun
Nakiboglu	Nakiboglu	properNoun
Vasilije	Vasilije	properNoun
Lika	Lika	properNoun
Miramida	Miramida	properNoun
Darka	Darka	properNoun
Sakik	Sakik	properNoun
Mylopoulos	Mylopoulos	properNoun
Shpresa	Shpresa	properNoun
Zirve	Zirve	properNoun
Godel	Godel	properNoun
Batt	Batt	properNoun
Prica	Prica	properNoun
Cordt	Cordon	properNoun
Lachev	Lachev	properNoun
Zalica	Zalique	properNoun
Vojin	Vojin	properNoun
Mitilinis	Mitilinis	properNoun
Karakachani	Karakachacan	properNoun
Gruban	Gruban	properNoun
Ottignon	Ottignon	properNoun
Paintsil	Peinture	properNoun
Kaboglu	Kaboglu	properNoun
Gudelevic	Gutelevic	properNoun
Hanchi	Hachi	properNoun
Ozal	Ozal	properNoun
Shimbun	Fanfaronner	properNoun
Demircan	Démiricain	properNoun
Golikova	Golikova	properNoun
Zelezarnica	Zelezarnica	properNoun
Klinger	Klinger	properNoun
Madl	Folle	properNoun
Veltroni	Veltroni	properNoun
Dunedin	Dunedin	properNoun
Guca	Guca	properNoun
Vahid	Vahaid	properNoun
Tsekov	Tsekov	properNoun
Pesin	Pesine	properNoun
Shinzo	Shinzo	properNoun
Avivi	Avivi	properNoun
Kelowna	Kelowna	properNoun
Moser	Moser	properNoun
Zderic	Zderique	properNoun
Raznatovic	Raznatovic	properNoun
Kalaba	Kalaba	properNoun
Pljesevica	Pljesevica	properNoun
Laibach	Laibach	properNoun
Pitu	Pitu	properNoun
Marchionne	Marchionne	properNoun
Stoykov	Stoykov	properNoun
Murgeanu	Murganu	properNoun
Mendoni	Mendoni	properNoun
Buyulu	Acheteur	properNoun
Berani	Berani	properNoun
Meljak	Meljak	properNoun
Prammer	Promard	properNoun
Shtime	Shtime	properNoun
Bolfa	Bêcheur	properNoun
Peretyatko	Peréyatko	properNoun
Rrecaj	Rrecaj	properNoun
Agaraj	Agaraj	properNoun
Ondjaki	ONDJAKI	properNoun
Inex	Inex	properNoun
Denko	Denko	properNoun
Penteli	Penteli	properNoun
Kalashnikov	Kalachnikov	properNoun
Negotin	Négociation	properNoun
Capgemini	Capgemini	properNoun
Ivajlo	Ivajlo	properNoun
Zlatograd	Zlatograd	properNoun
Trefalt	Trefalt	properNoun
Napredak	Napréak	properNoun
Slavomir	Slavomir	properNoun
Narval	Narval	properNoun
Konevska	Konevska	properNoun
Chalkias	Chalands	properNoun
Danailov	Danailov	properNoun
Treska	Treska	properNoun
Spindelegger	Spindélégger	properNoun
Surp	Surp	properNoun
Amuzgar	Amuzgar	properNoun
Nichita	Nichita	properNoun
Gerceker	Gerceker	properNoun
Antoniy	Antoniy	properNoun
Goknel	Goûter	properNoun
Bildt	Bildt	properNoun
Toepfer	Topper	properNoun
Kusari	Kusari	properNoun
Swati	Swati	properNoun
Panagiotopoulos	Panagiotopoulos	properNoun
Berislava	Berislava	properNoun
Seckin	Seconde	properNoun
Worns	Porté	properNoun
Petar	Pétar	properNoun
Vatamaniuc	Vitamaniuc	properNoun
Kucova	Kucova	properNoun
Molander	Masser	properNoun
Mabetex	Mabetex	properNoun
ZagrebDox	Zagrébdox	properNoun
Cinelli	Cinelli	properNoun
Borgo	Borgo	properNoun
Kalantzopoulos	Kalantzopoulos	properNoun
Ringier	Ridicule	properNoun
Drinos	Drinos	properNoun
Samandag	Samandag	properNoun
Medak	Médailler	properNoun
Shipka	Navireka	properNoun
Zawahiri	Zawahiri	properNoun
Arifay	Arifay	properNoun
Prifti	Priftti	properNoun
Barac	Barac	properNoun
Venyanovich	Venyanovich	properNoun
Negulesco	Negulesco	properNoun
at the end of	au bout du	properNoun
Shunyi	Shunyi	properNoun
Stryger	Strict	properNoun
Maccabi	Maccabi	properNoun
Kravica	Kravica	properNoun
Hoare	Houé	properNoun
Ruecker	Rucheur	properNoun
Sejad	Sejad	properNoun
Aliti	Aliti	properNoun
Mecanno	Meccano	properNoun
Sanitex	Sanitex	properNoun
Bojku	Bojku	properNoun
officiate	officier	verb
officiate	avoir une fonction	verb
officiate	travailler comme fonctionnaire	verb
officiate	officier	None
Nihil	Nihil	properNoun
Sodano	Sodano	properNoun
Alber	Allé	properNoun
Balus	Balus	properNoun
Bacau	Bacau	properNoun
Kula	Kula	properNoun
Shiddi	Shiddi	properNoun
Arenliu	Arenliu	properNoun
Tutu	le tutu	noun
Tutu	Tutu	None
Mujkic	Mujkic	properNoun
Doynova	Doynova	properNoun
Nesebar	Nesebar	properNoun
Crechet	Crèche	properNoun
Orasac	Orasac	properNoun
Bozhinov	Bozhinov	properNoun
Boge	Bougeoir	properNoun
Rraham	Rraham	properNoun
Lewalter	Lewalter	properNoun
Kaindl	Kaindl	properNoun
Allahu	Allahu	properNoun
Alpe	Alpe	properNoun
Huseyin	Huseyin	properNoun
Hajj	Hajj	properNoun
Munishi	Munishi	properNoun
be ready to go	être prêt à partir	properNoun
Loic	Lâche	properNoun
