Sagem	Sagem	properNoun
Kalesija	Kalesija	properNoun
Chora	Chora	properNoun
Dinescu	Dinecu	properNoun
Pisanu	Pisanu	properNoun
Quaestus	Questus	properNoun
Gousis	Gousis	properNoun
Fatmir	Faimère	properNoun
Hyok	Hyok	properNoun
Beqiri	Beqiri	properNoun
Tintor	Tinter	properNoun
Solotvino	Solotvino	properNoun
vocalise	vocalise	properNoun
Bosiljevo	Bosiljevo	properNoun
Mediana	Médiana	properNoun
Arifaj	Arifaj	properNoun
Cinecitta	Cinecitta	properNoun
Zubeyir	Zubeyir	properNoun
Tolay	Coucher	properNoun
Technodomiki	Technodomi	properNoun
Boxmark	Boxmark	properNoun
Sigonella	Sigonella	properNoun
Turktan	Turktan	properNoun
Ikonija	Ikonija	properNoun
Desterbeck	Deserbeck	properNoun
Krlovic	Krlovic	properNoun
Hebrosbank	Hebrosbank	properNoun
Lahdar	Lahdar	properNoun
Edgu	Edgu	properNoun
Brasoveanu	Brasheanu	properNoun
Tsakos	Tsakos	properNoun
Dimitrova	Dimitrova	properNoun
Paraschivu	Paraschivu	properNoun
WiFi	Wifi	properNoun
Molvaer	Molvail	properNoun
Zivka	Zivka	properNoun
Strasser	Strasseur	properNoun
Donji	Donji	properNoun
Behram	Behram	properNoun
Devnya	Dévénya	properNoun
Brosch	Brosse	properNoun
Mitrosrem	Mitrosrem	properNoun
Cinteza	Cintéza	properNoun
Kacarevic	Kacarevic	properNoun
Navrom	Navrom	properNoun
Mushkolaj	Mushkolaj	properNoun
Tomba	Tombeau	properNoun
lift the spirits	lever les esprits	properNoun
Hacibektasoglu	Hacibektasoglu	properNoun
Hristova	Hristova	properNoun
Basesgioglu	Basesgioglu	properNoun
Bagram	Bagram	properNoun
come upon	venir sur	properNoun
Roxelana	Roxelana	properNoun
Furis	Furieux	properNoun
Bregasi	Bregasi	properNoun
Neuf	Neuf	properNoun
Inva	Inva	properNoun
Florin	le florin	noun
Florin	Florin	None
Getro	Gettro	properNoun
Kadare	Kadare	properNoun
NeftegazInCor	Neftegazincor	properNoun
Driton	Driton	properNoun
Ciuhandu	Ciuhandu	properNoun
in response to	en réponse à	properNoun
Elzira	Elzira	properNoun
Attikon	Attikon	properNoun
Pernek	Perne	properNoun
Vitanova	Vitanova	properNoun
Kalou	Kalou	properNoun
Mandrescu	Mandrescu	properNoun
Anadolu	Anadolu	properNoun
Naftemporiki	Naftemporiki	properNoun
Mirush	Mirus	properNoun
Tilman	Tinman	properNoun
Kukric	Kukic	properNoun
Pupovac	Pupovac	properNoun
Rila	Rila	properNoun
Barbieri	Barbieri	properNoun
Rosbulgartabak	Rosbulgartabak	properNoun
Piedone	Pète	properNoun
Gerd	Gerd	properNoun
Solaja	Solaja	properNoun
Vaclav	Vaclav	properNoun
Kenge	Kenge	properNoun
Enoiu	Enoiu	properNoun
Evrim	Évier	properNoun
Molitva	Molitva	properNoun
Knezha	Knezha	properNoun
Aysenur	Aysenur	properNoun
Haudbourg	Haudbourg	properNoun
Dobroshi	Dobroshi	properNoun
Gezer	Gezer	properNoun
Dodecanese	le dodécanèse	noun
Dodecanese	Dodécanèse	None
Ozren	Ozren	properNoun
Anima	l' anima	noun
Anima	Anima	None
Abdulrashid	Abdulrashid	properNoun
Novi	Novi	properNoun
Guiglaris	Guiglamaris	properNoun
Zdeslav	ZDESLAV	properNoun
Horst	le môle	noun
Horst	Horst	None
Buall	Buall	properNoun
Kalduderski	Kalduderski	properNoun
Bawer	Caprice	properNoun
Pasare	Pasare	properNoun
Havel	Havel	properNoun
Kiras	Kiras	properNoun
Ramallah	Ramallah	properNoun
Seif	Seif	properNoun
Corina	Corina	properNoun
Evlija	Evlija	properNoun
Duygu	Diguer	properNoun
Sula	Sula	properNoun
Carnahan	Carnahan	properNoun
Altug	Altuge	properNoun
Gospic	Gospic	properNoun
Fojas	Foays	properNoun
Laengle	Laengle	properNoun
Loeb	Loab	properNoun
Soysal	Soyal	properNoun
Teodosie	Teodose	properNoun
Umwelt	Umwelt	properNoun
Poro	Poro	properNoun
Paroseni	Parenuni	properNoun
Tulea	Tulea	properNoun
Zervos	Zervos	properNoun
Gradevinarstva	Gradevinarstva	properNoun
Dobroslav	Dobroslav	properNoun
Igsiz	Igsiz	properNoun
Frederique	Frederique	properNoun
Skoda	Skoda	properNoun
Diwaniyah	Diwaniyah	properNoun
Denizlispor	Denizlispor	properNoun
Toros	Toros	properNoun
Erato	Erato	properNoun
Barbulescu	Barbulescu	properNoun
Bujanovac	Bujanovac	properNoun
Papadopoulou	Papadopoulou	properNoun
Telco	Telco	properNoun
Cbyra	Cbyra	properNoun
Kyriake	Kyriake	properNoun
Ormel	Ormique	properNoun
Trenevska	Trenevska	properNoun
Malina	Maladies	properNoun
Loamnes	Loamnes	properNoun
Cerkez	Cérkez	properNoun
Eurofound	Euros	properNoun
Krustev	Krustev	properNoun
Hasic	Hasic	properNoun
Napoca	Napoca	properNoun
Saydam	Saydam	properNoun
Presse	Presse	properNoun
Erceg	Erceg	properNoun
Hanule	Hanule	properNoun
Petrovec	Petrovec	properNoun
Uretim	Uretim	properNoun
Pekerman	Pekerman	properNoun
Karakocan	Karakocan	properNoun
Anelia	Anelia	properNoun
Dikmen	Dikmen	properNoun
Devoll	Dévoller	properNoun
Iveco	Iveco	properNoun
Dimitrovski	Dimitrovski	properNoun
Koulouri	Koulouri	properNoun
Mravlje	Marravlje	properNoun
Nimet	Nimet	properNoun
Mun	Mun	properNoun
Cocos	Cocos	properNoun
Dimitriadis	Dimitriadis	properNoun
Oluja	Oluya	properNoun
Orliakas	Orliakas	properNoun
Mobbing	assaillir	verb
Mobbing	se masser	verb
Mobbing	Mélange	None
Ulrike	Ultrike	properNoun
Milanov	Milanov	properNoun
Musaraj	Musaraj	properNoun
Ceco	Ceco	properNoun
Unis	Unis	properNoun
Lojze	Lâche	properNoun
MiGs	Migues	properNoun
protect oneself	se protéger	properNoun
Garganas	Garganas	properNoun
Soomro	Soomro	properNoun
Kitka	Kitka	properNoun
Metaj	Métaj	properNoun
Temin	Temin	properNoun
Ulku	Ulku	properNoun
Telesat	Télésat	properNoun
Schaeuble	Schaeuble	properNoun
Bezhanovo	Bezhanovo	properNoun
Divic	Divique	properNoun
Ruchi	Ruchi	properNoun
Oguzlan	Oguzlan	properNoun
Kefalonia	Kéfalonia	properNoun
Osijek	Osijek	properNoun
Petir	Pétir	properNoun
Veysi	Veysies	properNoun
Akbiyik	Akbiyik	properNoun
Rizvo	Rizvo	properNoun
Kemerburgaz	Kemerburgaz	properNoun
Blanculescu	Blanculescu	properNoun
Fak	Faiper	properNoun
Nebihe	NEBIHE	properNoun
Smeeianu	Smeanu	properNoun
Zoi	Zoi	properNoun
Zlateva	Zlateva	properNoun
Mihnea	MiNea	properNoun
Udum	Udum	properNoun
Topecsu	Topecsu	properNoun
Deloitte	Deloitte	properNoun
Siljegovic	Siljegovic	properNoun
Tecuci	Técuci	properNoun
Isufi	Isufi	properNoun
Sotiroulla	Sottiroulla	properNoun
Ecaterina	Ecaterina	properNoun
Lipa	Lipa	properNoun
Ince	Instaurer	properNoun
Luledzija	LULEDZIJA	properNoun
Sporturilor	Sporturilor	properNoun
Szinhaz	Szinhaz	properNoun
Akkuyu	Akkuyu	properNoun
Vigen	Vigue	properNoun
Bosniak	Bosniaque	properNoun
Ristani	Ristani	properNoun
Vb	Vb	properNoun
Umag	Umag	properNoun
Raonic	Raie	properNoun
Stipanov	Stipanov	properNoun
Kardas	Kardas	properNoun
Kravchenko	Kravchenko	properNoun
Keka	Keka	properNoun
Selmanaj	Selmanaj	properNoun
Sikeona	Sikeona	properNoun
Massari	Massari	properNoun
Versfeld	Versfeld	properNoun
Sabahudin	Sabahudin	properNoun
Vetendosje	Vetendosje	properNoun
Shkupi	Shkupi	properNoun
Hina	Hina	properNoun
Tsenov	Tsenov	properNoun
Zerihoun	Zérihoun	properNoun
Grifos	Griffe	properNoun
Muhaxheri	Muhaxheri	properNoun
Varujan	Varujan	properNoun
Briceag	Brête	properNoun
Zengin	Zengin	properNoun
Ozbek	Ozbek	properNoun
Ajnishahe	Ajnishahe	properNoun
Fethi	Frethi	properNoun
Nicholl	Nicholl	properNoun
Otesi	Otesi	properNoun
Natsios	Natsios	properNoun
Austro	Austro	properNoun
Hangan	Hangen	properNoun
Azari	Azari	properNoun
Usce	Usce	properNoun
MakTel	Maktel	properNoun
Krzysztof	Krzysztof	properNoun
Labovic	Labovic	properNoun
Koustsilieri	Koussilieri	properNoun
Saplacan	SAPLACAN	properNoun
Kamberov	Kamberov	properNoun
Essonne	Esson	properNoun
Topbas	Topbas	properNoun
Sazdov	Sazdov	properNoun
Dun	le brun grisâtre	noun
Dun	le cheval louvet	noun
Dun	sombre	adjective
Dun	brun foncé	adjective
Dun	Faire du bruit	None
Sao	Sao	properNoun
Bucuresti	Bucuresti	properNoun
Acharya	Acharya	properNoun
Genova	Gêne	properNoun
Osmanbey	Osmanbey	properNoun
Totozani	Totozani	properNoun
Weybridge	Weybridge	properNoun
Pervez	Pervoir	properNoun
Pencho	Pencho	properNoun
Baykam	Baykam	properNoun
Sudului	Sudului	properNoun
Kretschmer	Kretschmer	properNoun
Gencay	Gencay	properNoun
Perseids	Perséhés	properNoun
Bortnianski	Bortnianski	properNoun
Scheonfelder	Scheonfelder	properNoun
Thessaliotis	Thessaliotis	properNoun
Mlikota	Mlikota	properNoun
Briseno	Briseno	properNoun
Atakuman	Atakuman	properNoun
Gogov	Gogov	properNoun
Ilijaz	Ilijaz	properNoun
Sombor	Sombolbor	properNoun
Lustig	Lustig	properNoun
Pitarka	Piarçon	properNoun
Nuredin	Nuredin	properNoun
Zugdidi	Zugdidi	properNoun
Anand	Anand	properNoun
Antonijevic	Antonijevic	properNoun
Stig	Stig	properNoun
Marjorie	Marjorie	properNoun
Aaviksoo	Aaviksoo	properNoun
Darmanovic	Darmanovic	properNoun
Hirschfeld	Hirschfeld	properNoun
Zejra	Zejra	properNoun
Miloje	Miloje	properNoun
Taniguchi	Taniguchi	properNoun
Zepter	Zeptère	properNoun
RiverRun	Riverain	properNoun
Daliborka	Daliborka	properNoun
Cancun	Cancun	properNoun
Arie	l' aria	noun
Arie	Arie	None
Boumediene	Boumediène	properNoun
Cakran	Cakran	properNoun
Crkolez	Crakolez	properNoun
Nepravishta	Nepravishta	properNoun
Intelsat	Intelsat	properNoun
Murtezaj	Murtezaj	properNoun
Schavan	Schavan	properNoun
Trajanoski	Trajanoski	properNoun
Arditti	Arditti	properNoun
Selulozik	Selulozik	properNoun
Zeynal	Zeynal	properNoun
Kotsovolos	Kotsovolos	properNoun
Perica	Périque	properNoun
Durukan	Durukan	properNoun
Mashall	Marshall	properNoun
Carshove	Carapace	properNoun
Huch	Huch	properNoun
Vucjak	Vucjak	properNoun
Cadikovski	Cadikovski	properNoun
Kazdagli	Kazdaglari	properNoun
Umcare	Upcare	properNoun
Tripkovic	Tripkovic	properNoun
Kelava	Kelava	properNoun
Isak	Isak	properNoun
Natan	Natan	properNoun
Liplje	Liplje	properNoun
Myung	Myung	properNoun
Bleiburg	Bleiburg	properNoun
Pompea	Pompe	properNoun
Tarus	Taus	properNoun
Seyret	Seyret	properNoun
Meglenska	Meglenska	properNoun
hydropower plant	centrale hydroélectrique	properNoun
Meta	Méta	properNoun
Magrath	Magrath	properNoun
Aspendos	Aspendos	properNoun
Eversheds	Everseheds	properNoun
Paten	la patène	noun
Paten	Patène	None
Asashoryu	Asashoryu	properNoun
Palo	Palo	properNoun
Boginya	Boginya	properNoun
Duda	Digue	properNoun
gnash	le grincement	noun
gnash	grincer des dents	verb
gnash	grincement	None
Gerti	Gerti	properNoun
Remaj	Remaj	properNoun
Gokcebag	Gokcebag	properNoun
Eurobank	Eurobank	properNoun
Foča	Foča	properNoun
Brandeis	Brandeis	properNoun
Elektroprivreda	Elektroprivreda	properNoun
Ilkhan	Ilkhan	properNoun
Bigorski	Bigorski	properNoun
Mpumalanga	Mpumalanga	properNoun
Ashvin	Ashvin	properNoun
Morinj	Morinj	properNoun
Minotti	Minotti	properNoun
Hinseberg	Hinsberg	properNoun
Masashi	Masashi	properNoun
Vasiliki	Vasiliki	properNoun
Filote	Filote	properNoun
Ozdem	Ozdem	properNoun
Targoviste	Targoviste	properNoun
Concordia	Concordia	properNoun
Calislar	Callar	properNoun
Lollobrigida	Lollobrigida	properNoun
Orhan	Orhan	properNoun
Mamutovic	Mamutovic	properNoun
Cupica	Cupique	properNoun
Buzau	Buzau	properNoun
Vulcheva	Vulcheva	properNoun
Mestrovic	Mestrovic	properNoun
Nimani	Nimani	properNoun
Prelec	Prelec	properNoun
Doosan	Doosan	properNoun
Ates	Aille	properNoun
Sayari	Shayari	properNoun
Kainovski	Kainovski	properNoun
Momferatos	Momferatos	properNoun
Rexhe	Rex	properNoun
Leku	Leku	properNoun
Etleva	Etleva	properNoun
Misbah	Malheureux	properNoun
Hellenikon	Hellénikon	properNoun
Cutiliero	Cuttiliero	properNoun
Rexhaj	Rexhaj	properNoun
Kocyigit	Kocyigit	properNoun
Dasoz	Dasoz	properNoun
Petkova	Pékova	properNoun
Sylikiotis	Sylikiotis	properNoun
Polje	Polje	properNoun
Bouikidis	Boukidis	properNoun
Desislava	Desislava	properNoun
Caranfil	Caranfil	properNoun
Velevski	Velevski	properNoun
Lukina	Lukina	properNoun
Razlog	Razlog	properNoun
Elsie	Elsie	properNoun
Ercakica	Ercakica	properNoun
Senahid	Senahid	properNoun
Henault	Henault	properNoun
Agong	Agon	properNoun
Miranovic	Miranovic	properNoun
Vedrana	Védrana	properNoun
smuggling	la contrebande	noun
smuggling	contrebande	None
Shomodji	Shomodji	properNoun
Nebojsa	Nebojsa	properNoun
Mihailo	Mihailo	properNoun
Krusik	Krusik	properNoun
Rafina	Rafina	properNoun
Majkic	Majkique	properNoun
Muhiddin	Muhiddin	properNoun
Salihaj	Salihaj	properNoun
Kosutnjak	Kosutnjak	properNoun
Fezal	Feux	properNoun
Viëtor	Vœu	properNoun
Privatinvest	Privatinvest	properNoun
Banja	Banja	properNoun
Bozinovska	Bozinovska	properNoun
Ardelean	Ardélian	properNoun
Smilev	Smilev	properNoun
Carafoli	Carafoli	properNoun
Voronin	Voronine	properNoun
Iseni	Iseni	properNoun
Ladjevci	Ladjevci	properNoun
Galev	Gale	properNoun
Stavri	Stavri	properNoun
Balaburski	Balaburski	properNoun
Ozdemir	Ozdemir	properNoun
Tabanovce	Tabanovce	properNoun
Vinatzer	Vinatzer	properNoun
Grecianii	Grecianii	properNoun
Panathinaikos	Pancathinaïkos	properNoun
Bombaks	Bombardier	properNoun
Logoglu	Logoglu	properNoun
Zequiri	Zequiri	properNoun
Koutroumanidou	Koutroumanidou	properNoun
Constandinos	Consttandinos	properNoun
Tomec	Tomec	properNoun
Blewitt	Bêtise	properNoun
Ulcinj	Ulcinj	properNoun
Taner	Tanner	properNoun
Sureyya	Sureyya	properNoun
Buconjic	Buconjic	properNoun
Racosul	Racos	properNoun
Dilmener	Dilmène	properNoun
Thanassis	Thanassis	properNoun
Lagris	Lagris	properNoun
Mocanu	Mocanu	properNoun
Orgonas	Orgonas	properNoun
Lipljan	Lipljan	properNoun
Fruska	Fruska	properNoun
Zibak	Zibak	properNoun
Mrvica	Mrvica	properNoun
Hatunije	Hatunije	properNoun
Sipovic	Sipovic	properNoun
Kadina	Kadina	properNoun
Hochtief	Hochtie	properNoun
Minikes	Minikes	properNoun
Glencore	Glencore	properNoun
Baftijar	Baftijar	properNoun
Behgjet	Behgjet	properNoun
Dujmovic	Dujmovic	properNoun
Liaoning	Liaison	properNoun
Metiner	Métiner	properNoun
Lazarevski	Lazarevski	properNoun
Toba	Toba	properNoun
Muhaxhiri	Muhaxhiri	properNoun
Parnes	Parnes	properNoun
Sitaru	Sitaru	properNoun
Karlovo	Karlovo	properNoun
Lolova	Lolova	properNoun
Kehl	Kehl	properNoun
Bobotov	Bobotov	properNoun
Kounoupidiana	Kounoupidiana	properNoun
Kushljugic	Kusljugic	properNoun
Themba	Themba	properNoun
Meglena	Méglène	properNoun
Njegus	Njegus	properNoun
Bitef	Mordre	properNoun
Eboue	Éboueur	properNoun
Framatome	Framatome	properNoun
Rosia	Rosie	properNoun
Michaletos	Michametos	properNoun
Biljalji	Biljalji	properNoun
Mutafchiev	Mutafchiev	properNoun
Vajgl	Vajgl	properNoun
Winfried	Winfried	properNoun
Bilalovic	Bilalovic	properNoun
Tivat	Tivat	properNoun
Shopska	Shopska	properNoun
Univerzalni	Univerzalni	properNoun
Krga	Krga	properNoun
Nicolaou	Nicolaou	properNoun
Galijasevic	Galjasevic	properNoun
Karandila	Karandila	properNoun
Kutlay	Kulay	properNoun
Frunda	Friendale	properNoun
Ogulcan	Ogulcan	properNoun
Shengjin	Shengjin	properNoun
Ataka	Ataka	properNoun
Mavi	Mavi	properNoun
Colston	Colston	properNoun
Muhammedmian	Muhammedmien	properNoun
Georgi	Georgi	properNoun
Poutiainen	Poudiain	properNoun
Cakmakoglu	Cakmakoglu	properNoun
Efrim	Efrim	properNoun
Gnjilane	Gnjilane	properNoun
Karolina	Karolina	properNoun
Kier	Kier	properNoun
Cengiz	Cengiz	properNoun
Calik	Calik	properNoun
Realitatea	Realitatea	properNoun
Enno	Ennuyer	properNoun
Olofsson	Olofsson	properNoun
Unu	UNU	properNoun
Drymonakos	Drymonakos	properNoun
Rahma	Rahma	properNoun
Akkopru	Akkopru	properNoun
Lirie	Lirie	properNoun
Kather	Kather	properNoun
Wunenberger	Wunenberger	properNoun
Fijuljanin	Fijuljanin	properNoun
Razbezhkina	Razbezhkina	properNoun
Kasapolli	Kasapolli	properNoun
Tizard	Tizard	properNoun
Scotsman	Écossais	properNoun
Necip	Necip	properNoun
Hulya	Hulya	properNoun
Timfoldgyar	Timfolgyar	properNoun
Svetieva	Sveva	properNoun
Wahlund	Wahlund	properNoun
Kosarac	Kosarac	properNoun
Istasyon	Istasyon	properNoun
Elif	Elif	properNoun
Cebeci	Cebeci	properNoun
Bishev	Bishev	properNoun
Eunet	Eunette	properNoun
Capar	Caparie	properNoun
Hisarciklioglu	Hisiviklioglu	properNoun
Genci	Genci	properNoun
Davorka	Davours	properNoun
Dedinje	Dédié	properNoun
Trebisnjici	Trebisnjici	properNoun
Mogamed	Mogamed	properNoun
Aksaray	Aksaray	properNoun
Kutluk	Kutluk	properNoun
Oger	Oger	properNoun
Sejamini	Sejamini	properNoun
Sevdah	Sevdah	properNoun
Bektashi	Bektashi	properNoun
Furqan	Furqan	properNoun
Dorohoi	Dorohoi	properNoun
Ragnar	Ragnar	properNoun
Vaira	Vaira	properNoun
Sikirica	Sikirica	properNoun
Megatrends	Megatrends	properNoun
Trebisnjica	Trebisnjica	properNoun
Triet	Tremande	properNoun
Shkopet	Shkopet	properNoun
Laaneots	Laaigne	properNoun
Lamers	Lamers	properNoun
Tanzer	Tanzer	properNoun
Broadarica	Broadarica	properNoun
Capralos	Caprralos	properNoun
Ilinden	Ilinden	properNoun
Ballsh	Balle	properNoun
Paschalidis	Paschalidis	properNoun
Trpevska	Trpevska	properNoun
Polip	Polaire	properNoun
Degert	Dégert	properNoun
Hotar	Hottare	properNoun
Treloar	Trembloar	properNoun
Avdiaj	Avdiaj	properNoun
Glamur	Glamour	properNoun
Stiglitz	Stiglitz	properNoun
Jarinje	Jarinje	properNoun
Rakipi	Rakipi	properNoun
Kyprinos	Kyprinos	properNoun
Wölkner	Wölkner	properNoun
Anas	Anas	properNoun
Lufter	Lufter	properNoun
Aristidis	Aristidis	properNoun
Hakkonen	Hakkonen	properNoun
Debrecen	Debrecen	properNoun
Lvovski	Lvovski	properNoun
Vala	Vala	properNoun
Gajin	Gaijin	properNoun
Tumbe	Tambeau	properNoun
Sremski	Sremski	properNoun
Predescu	Prefescu	properNoun
Iliev	Iliev	properNoun
Topalov	Topalov	properNoun
acquis	acquis	properNoun
Shobolev	Shobolev	properNoun
Georgescu	Georgescu	properNoun
piece of wood	morceau de bois	properNoun
Harxhi	Harxhi	properNoun
Vamvakidis	Vamvakidis	properNoun
Seadetin	Seadettin	properNoun
Comaneci	Comaneci	properNoun
Feni	Fantaisie	properNoun
Ikem	Ikem	properNoun
Sretno	Sretino	properNoun
Amano	Amano	properNoun
Nika	Nika	properNoun
Milivoje	Milvoje	properNoun
Gantelet	Loupe	properNoun
Bienale	Biennale	properNoun
Halandri	Halandri	properNoun
Sisecam	Sisecam	properNoun
Tamada	Tamada	properNoun
Riker	Riker	properNoun
Xinhuanet	Xinhuanet	properNoun
Hakaj	Hakaj	properNoun
Poltavchenko	Poltavchenko	properNoun
Prokurative	Prokuratif	properNoun
Birand	Bizarre	properNoun
Iskar	Iskar	properNoun
Cankaya	Cankaya	properNoun
Skylogiannis	Skylogiannis	properNoun
Krichbaum	Krichbaum	properNoun
Permeti	Perméti	properNoun
Ilka	Ilka	properNoun
Nikolaus	Nikolaus	properNoun
Kazim	Kazim	properNoun
Ozkok	Ozkok	properNoun
Tempe	Tempe	properNoun
Uljanik	Uljanik	properNoun
Elekdag	Elekdag	properNoun
Kaminen	Kaminen	properNoun
Okta	Okta	properNoun
Omis	Omis	properNoun
Mantog	Mantogue	properNoun
Valya	Valya	properNoun
Librex	Librex	properNoun
Makedonium	Makédonium	properNoun
Kitov	Kitov	properNoun
Corkovic	Corkovic	properNoun
Dodov	Dodou	properNoun
Topali	Topali	properNoun
Nikolov	Nikolov	properNoun
Dajti	Dajti	properNoun
Beslic	Beslique	properNoun
Geleta	Groette	properNoun
Zvizdic	Zvizdic	properNoun
Gornji	Gornji	properNoun
Pranvera	Pranvera	properNoun
Stojadinovic	Stojadinovic	properNoun
Kovac	Kovac	properNoun
Modigliani	Modigliani	properNoun
Plaveti	Plaveti	properNoun
Transki	Transki	properNoun
Ugur	Degure	properNoun
Varnavas	Varnavas	properNoun
Pekevski	Pekevski	properNoun
Gurak	Gurrak	properNoun
Arus	Arus	properNoun
Sretko	Sretko	properNoun
Trebjesanin	Trebjesanin	properNoun
Rudina	Rudina	properNoun
Indeksonline	Indeksonline	properNoun
Gazmend	Gonfler	properNoun
Tzipi	Tzipi	properNoun
Rouvas	Retrouva	properNoun
Freizer	Freiner	properNoun
Snoop	espionner	verb
Snoop	fouiner	verb
Snoop	fureter	verb
Snoop	fouiller	verb
Snoop	jeter un regard discret	verb
Snoop	le fouineur	noun
Snoop	l' espion	noun
Snoop	le détective	noun
Snoop	Espionner	None
Valimo	Valimo	properNoun
Zalau	Zalau	properNoun
Kavouri	Kavouri	properNoun
Fazlija	Fazlija	properNoun
Lambours	Lambours	properNoun
Kiriyenko	Kiriyenko	properNoun
Burmio	Burmi	properNoun
Garabet	Garbette	properNoun
Amorim	Amorim	properNoun
Oberth	Oberth	properNoun
Mavrocordat	Mavrocordat	properNoun
Lushkaku	Lushkaku	properNoun
Stricli	Stricli	properNoun
Pazardjik	Pazardjik	properNoun
Kvigne	Kvigne	properNoun
Ouyang	Ouyang	properNoun
Parnardziev	Parnardziev	properNoun
Kajmovic	Kajmovic	properNoun
Labrousse	Labrousse	properNoun
Weldon	Soudoyer	properNoun
Kalavryta	Kalavryta	properNoun
Starrach	Starrach	properNoun
Irecson	Irecson	properNoun
Modric	Modéré	properNoun
Kewell	Kewell	properNoun
Perge	Percer	properNoun
Giesecke	Gesecke	properNoun
Mirchev	Mirchev	properNoun
come to be	devenir	properNoun
Marmora	Marmora	properNoun
Zahrobska	Zahrobska	properNoun
Freas	Se soulever	properNoun
Xafa	XAFA	properNoun
Baysak	Bassin	properNoun
Latinica	Latinique	properNoun
Zhivkov	Zhivkov	properNoun
Zujanje	Zujanje	properNoun
Ascenta	Ascentas	properNoun
Polymeros	Polyméros	properNoun
Rukavina	Rukavina	properNoun
Boros	Boros	properNoun
Lokke	Lokke	properNoun
PlanetSky	Planète	properNoun
Marceta	Marceta	properNoun
e-trade	commerce électronique	properNoun
Hrncic	Hrncique	properNoun
Peto	Peo	properNoun
Durgut	Durgut	properNoun
Trigrad	Trigrad	properNoun
Svadba	Svadba	properNoun
Malteser	Malteseur	properNoun
Les	Les	properNoun
Traavik	Traavik	properNoun
Vjeran	Vjéran	properNoun
Kozulj	Kozulj	properNoun
Mojkovac	Mojkovac	properNoun
Dacioglu	Dcioglu	properNoun
Atilla	Atilla	properNoun
Rollier	Rollier	properNoun
Melchior	Melchior	properNoun
Bijela	Bijela	properNoun
BuskerFest	Buskerfest	properNoun
Volker	Volker	properNoun
supply water	approvisionnement en eau	properNoun
Igi	IGI	properNoun
Kargo	Kargo	properNoun
Swisshotel	Swissotel	properNoun
Kram	Kram	properNoun
Serbica	Serbica	properNoun
Suknaic	Suknaic	properNoun
shale	le schiste argileux	noun
shale	l' argile schisteuse	noun
shale	schiste argileux	None
Katana	Katana	properNoun
Altinay	Altinay	properNoun
Irinel	Irinelle	properNoun
Kinovska	Kinovska	properNoun
Soja	Soja	properNoun
Hossu	Hossu	properNoun
Alumir	Alumir	properNoun
Videnja	Videnja	properNoun
Laplje	Laplje	properNoun
Cladovei	Cladovei	properNoun
Barnuevo	Barnuevo	properNoun
Gottlieb	Gottlieb	properNoun
Riinvest	Riinvest	properNoun
Merovo	Merovo	properNoun
Zlatomir	Zlatomir	properNoun
Prizreni	Prizreni	properNoun
Velipoja	Velipoja	properNoun
Moldoveanu	Moldaveanu	properNoun
Podroom	Podomètre	properNoun
Okidoki	Oki Doki	properNoun
Herastrau	Herastrau	properNoun
Capaliku	Capaliku	properNoun
Stup	Stupéfier	properNoun
Kallimarmaro	Kallimarharo	properNoun
Aghia	Aghia	properNoun
Pavlou	Pavlou	properNoun
Lundeejantsan	Lundeejantsan	properNoun
Alkars	Alkars	properNoun
Podkrepa	Podkrepa	properNoun
Dudin	Maudit	properNoun
Tinsley	Tonney	properNoun
Mima	Mima	properNoun
Zeljic	Zeljic	properNoun
Sundt	Sundt	properNoun
Nasya	Nasya	properNoun
Dejiang	Dégoûter	properNoun
Baghdadi	Baghdadi	properNoun
Megatron	Mégatron	properNoun
Hudeifa	Hudeifa	properNoun
Sistina	Sistina	properNoun
Muca	Muca	properNoun
Pilsen	Pilsen	properNoun
Vegyepszer	Vegyepszer	properNoun
Ozbolt	Ozbolt	properNoun
Ulpia	Ulpia	properNoun
Necmi	Necmi	properNoun
Rozhen	Rozhen	properNoun
Kertes	Kertes	properNoun
Eurohorizons	Eurhorizons	properNoun
Bobot	Bobot	properNoun
Susica	Susica	properNoun
Antonov	Antonov	properNoun
Bosbach	Bosbach	properNoun
Neza	Neza	properNoun
Moscholiou	Moscholiou	properNoun
Bjenaru	Bjenaru	properNoun
Hushove	Husher	properNoun
Babovic	Babovic	properNoun
Refet	Refet	properNoun
Hajj	Hajj	properNoun
Stoltenberg	Stoltenberg	properNoun
Oceanus	Océanus	properNoun
Stiprais	Stipiris	properNoun
Akcelik	Akcelik	properNoun
Panco	Panco	properNoun
Pasha	le pacha	noun
Pasha	Pacha	None
Kanaris	Kanaris	properNoun
Tesanovic	Tsanovic	properNoun
Kyrenia	Kyrenia	properNoun
Zannier	Zannier	properNoun
Pande	Pande	properNoun
Lilana	Lilana	properNoun
Drecun	Drogué	properNoun
Perrenjas	Perronjas	properNoun
Vygaudas	Vygaudas	properNoun
Premci	Premci	properNoun
Altenmarkt	Altenmarkt	properNoun
Kuke	Kuke	properNoun
Sega	Sega	properNoun
Mete	infliger	verb
Mete	donner	verb
Mete	décerner	verb
Mete	la frontière	noun
Mete	Infliger	None
Ashtron	Ashtron	properNoun
Idalion	Idalion	properNoun
Sheremetyevo	Sheremetyevo	properNoun
Gafur	Gafur	properNoun
Petek	Pète	properNoun
Mesa	la mesa	noun
Mesa	Mesa	None
Mahlyanov	Mahlyanov	properNoun
Schuettler	Schuettler	properNoun
Kasindol	Kasindol	properNoun
Qi	Qi	properNoun
Samim	Samim	properNoun
Amitea	Amite	properNoun
Brichambaut	Brichambaut	properNoun
Sinead	Sinead	properNoun
Tulin	Tulin	properNoun
Lekaj	Lekaj	properNoun
Kadriu	Kadriu	properNoun
Granoff	Granoff	properNoun
Vourloumis	Vourloumis	properNoun
Puka	Puka	properNoun
Hangzhou	Hangzhou	properNoun
Libertatea	Libertatea	properNoun
Doromaud	Doromaud	properNoun
Menka	Menka	properNoun
Ceku	Casku	properNoun
Băsescu	Băsescu	properNoun
Babaoglu	Babaoglu	properNoun
Kiniklioglu	Kiniklioglu	properNoun
Loncarevic	Loncarevic	properNoun
Kusonje	Kusonje	properNoun
Karabatic	Karabatique	properNoun
Hramin	Hramin	properNoun
Illuminati	Illuminati	properNoun
Kresimir	Kreesimir	properNoun
Erol	Erol	properNoun
Moikom	Mokom	properNoun
Sanela	Sanela	properNoun
Ziua	Ziua	properNoun
Danijel	Danijel	properNoun
Vinca	Vinca	properNoun
Videva	Videva	properNoun
Frantishek	Frénétique	properNoun
Maroussi	Maroussi	properNoun
Cesme	CESME	properNoun
Rasol	Rasol	properNoun
Polydoras	Polydoras	properNoun
Berhad	Berhad	properNoun
Dacheva	Dacheva	properNoun
Costinesti	Costinuisti	properNoun
Zival	Zival	properNoun
Khalifa	Khalifa	properNoun
Tsuladze	Tsuladze	properNoun
Minov	Minov	properNoun
Huang	Huang	properNoun
Aivaliotis	Aubiottis	properNoun
Narli	Narli	properNoun
Bajnai	Bajnai	properNoun
Ishak	Ishak	properNoun
Kuyas	Kuyas	properNoun
intersecting	sécante	adjective
intersecting	sécant	None
Mevlut	MEVLUT	properNoun
Katsav	Katsav	properNoun
Deppler	Représailles	properNoun
Daskalov	Daskalov	properNoun
Serafim	Sérafim	properNoun
Samarakis	Samarakis	properNoun
Breyten	Breyten	properNoun
Focus	concentrer	verb
Focus	se concentrer	verb
Focus	faire converger	verb
Focus	faire le point	verb
Focus	le foyer	noun
Focus	le centre	noun
Focus	la concentration	noun
Focus	la distance focale	noun
Focus	l' infection focale	noun
Focus	Se concentrer	None
Vladicin	Vladicine	properNoun
Miljevina	Miljevina	properNoun
Dimka	Dimka	properNoun
make do	se contenter	verb
make do	se contenter	None
Vratnik	Vratnik	properNoun
Gruev	Gruev	properNoun
Eurasianet	Eurasiane	properNoun
Beta	le bêta	noun
Beta	Bêta	None
Sabo	Sabo	properNoun
Greicevci	Greicevci	properNoun
Sharr	Shard	properNoun
Memli	Memli	properNoun
Gucht	Gucht	properNoun
Aleksijev	Aleksijev	properNoun
Rompetrol	Rompetrol	properNoun
Nektarijevic	NEKTARIJEVIC	properNoun
Alad	Alade	properNoun
Uygun	Uygun	properNoun
Mesihovina	Mesihovina	properNoun
Andros	Andros	properNoun
Stanescu	Stanescu	properNoun
Kelemendi	Kelemendi	properNoun
Schuessel	Schuessel	properNoun
Eurosport	Eurosport	properNoun
Sydow	Sydow	properNoun
Marinakis	Marinakis	properNoun
Qytetari	Qytetari	properNoun
Radivojevic	Radivojevic	properNoun
Rader	Radier	properNoun
Gonul	Gonol	properNoun
Rusalka	Ruska	properNoun
Afroudakis	Afradakis	properNoun
Gordan	Gordan	properNoun
liability	la responsabilité	noun
liability	les dettes	noun
liability	l' handicap	noun
liability	la susceptibilité	noun
liability	responsabilité	None
Qingyang	Qingyang	properNoun
Perker	Perker	properNoun
Seadeta	Seadeta	properNoun
Algoritam	Algoritam	properNoun
Surma	Surma	properNoun
Radojko	Radojko	properNoun
Laganin	Laganin	properNoun
Hristofias	Hristofias	properNoun
Engin	Engin	properNoun
Zeyrek	Zeyrek	properNoun
Zlokukjani	Zlokukjani	properNoun
Blazhev	Blazhev	properNoun
Arg	Argument	properNoun
Izet	Izet	properNoun
Prelevic	Prelevic	properNoun
Aljinovic	Aljinovic	properNoun
Ungheni	Ungheni	properNoun
Fleiner	Fleuron	properNoun
Vidovo	Vidovo	properNoun
Pleon	Pléon	properNoun
Himalaya	Himalaya	properNoun
Sargan	Sargan	properNoun
Hukic	Hukic	properNoun
Avdeeva	Avdeeva	properNoun
Arjen	Arjen	properNoun
Rilindja	Rilindja	properNoun
Mirusa	Mirusa	properNoun
Kivu	Kivu	properNoun
Mitovski	Mitovski	properNoun
Chalabi	Chalabi	properNoun
Agir	Agir	properNoun
Sancrainei	Sancrainei	properNoun
Elitsa	Elitsa	properNoun
Kontic	Kontique	properNoun
Cochilet	Cochilet	properNoun
Vistica	Viticole	properNoun
Chankov	Château	properNoun
Nukhet	Nukhet	properNoun
Nikolova	Nikolova	properNoun
Hanescu	Hanescu	properNoun
Orsalia	Orsalia	properNoun
Agronet	Agronét	properNoun
Lumpur	Lumpur	properNoun
forsee	rentrée	properNoun
Ohmae	Ohmae	properNoun
Blidaru	Blidaru	properNoun
Wengen	Wengen	properNoun
Sarancic	Sarancique	properNoun
Makic	Makic	properNoun
Hyparlo	Hyparlo	properNoun
Ismaili	Ismaili	properNoun
Adnan	Adnan	properNoun
Renier	Reniférable	properNoun
Osojan	Osojan	properNoun
Leste	Laté	properNoun
Kirsch	le kirsch	noun
Kirsch	kirsch	None
Kovachki	Kovachki	properNoun
Schinias	Schinias	properNoun
Comerciala	Comerciala	properNoun
Madalina	Madaline	properNoun
Stobi	Sobi	properNoun
Lugavic	Lugavique	properNoun
Vitol	Vitol	properNoun
Livadia	Livadia	properNoun
Batum	Batum	properNoun
Chappel	Chappel	properNoun
Vorkink	Vorkink	properNoun
Aletleri	Aletleri	properNoun
Postolache	Postolache	properNoun
Fierza	Fuerza	properNoun
Slavjanski	Slavjanski	properNoun
Trgoviste	Trgoviste	properNoun
Leterme	Time	properNoun
Mondevideo	Montevideo	properNoun
Sisay	Sisay	properNoun
Stojarova	Stojarova	properNoun
Nevena	Nevena	properNoun
Katimerini	Kathimerini	properNoun
Zrinka	Zrinka	properNoun
Taipi	Taipi	properNoun
Pezo	Pézo	properNoun
Bianku	Bianku	properNoun
Prahova	Prahova	properNoun
Dulgheru	Dulgheru	properNoun
Porec	Porc	properNoun
Livno	Livno	properNoun
Porozhanov	Porozhanov	properNoun
Ferati	Ferati	properNoun
Luani	Luani	properNoun
Babis	Babis	properNoun
Lidhja	Lidhja	properNoun
Villalain	Villalain	properNoun
Charalampos	Charalampos	properNoun
Cozmina	Cozmina	properNoun
Hasani	Hasani	properNoun
Bogdanci	Bogdanci	properNoun
Nerguizian	Nerguizien	properNoun
Sencap	Voyou	properNoun
Vidoje	Vidoje	properNoun
Tv	La télé	properNoun
Cealik	Calik	properNoun
Schild	Schild	properNoun
Hiber	Hurlement	properNoun
Scotti	Scotti	properNoun
Naumovska	Naumovska	properNoun
Galata	Galatta	properNoun
Transstroy	Travstroy	properNoun
Etihad	Etihad	properNoun
Fotopoulos	Fotopoulos	properNoun
Miralem	Miralem	properNoun
Solyom	Solitant	properNoun
Dracevac	Dracevac	properNoun
Veriga	Veriga	properNoun
Rakovica	Rakovica	properNoun
Erzeni	Erzeni	properNoun
Penusliski	Penusliski	properNoun
Misev	Misev	properNoun
Sebnem	Sebnem	properNoun
Attalus	Attalus	properNoun
Camilla	Camilla	properNoun
Putnam	Putamam	properNoun
Neft	Neft	properNoun
Chrysostomos	Chrysostomos	properNoun
Hasanaj	Hasanaj	properNoun
Chawla	Chawla	properNoun
Abdumenaf	Abduménaf	properNoun
Ethnics	Ethnie	properNoun
Kratovo	Kratovo	properNoun
Liberatum	Libératum	properNoun
Edin	Édin	properNoun
Cherni	Cherni	properNoun
Leposavic	Leposavique	properNoun
Apakan	Apakan	properNoun
Mladjan	Mladjan	properNoun
Halal	la viande hallal	noun
Halal	Halal	None
Theofilos	Théofilos	properNoun
Gligorie	Gligorie	properNoun
Nocioni	Nocioni	properNoun
Kadrush	Kadrush	properNoun
Thorbjorn	Thorbjorn	properNoun
Cro	Cro	properNoun
Lado	Lâche	properNoun
Tekel	Takel	properNoun
Gecitkoy	Gecitkoy	properNoun
Arneric	Arneric	properNoun
Becic	Becique	properNoun
Partenkirchen	Partenkirchen	properNoun
TeamNet	Tibia	properNoun
Euroinvent	Euro	properNoun
Seviciu	Seviciu	properNoun
Pirin	Pirin	properNoun
Medvednica	Medvednica	properNoun
Limami	Limami	properNoun
Paraskevi	Paraskevi	properNoun
Stoilkovski	Soilkovski	properNoun
Zagorka	Zagours	properNoun
Iures	Iures	properNoun
Moalem	Moalem	properNoun
Stevan	Stevan	properNoun
Riviera	Riviera	properNoun
Ardic	Ardic	properNoun
Bembasa	Bembasa	properNoun
Huseynov	Huseynov	properNoun
Serduchka	Serduchka	properNoun
Sabri	Sabri	properNoun
Dangov	Dangov	properNoun
Elira	Elira	properNoun
Proell	Procede	properNoun
Bork	Bork	properNoun
Karacan	Karacan	properNoun
Rambouillet	Rambouillet	properNoun
Huzeyfe	Huzeyfe	properNoun
Mebrulja	Mebrulja	properNoun
Seyed	Séparé	properNoun
Memur	Souvenir	properNoun
Sebes	Sebés	properNoun
Timofti	Timofti	properNoun
Osvit	Osvit	properNoun
Statkraft	Statistique	properNoun
Castagnotto	Castagnotto	properNoun
Zvonko	Zvonko	properNoun
Baci	Baci	properNoun
Odžalan	Odžalan	properNoun
Ostojic	Ostojic	properNoun
Zajecar	Zajecar	properNoun
Puddington	Puddington	properNoun
Lutfi	Lufi	properNoun
Vatreni	Vateni	properNoun
Ozev	Ozev	properNoun
Nenovski	Nenovski	properNoun
Erechtheion	Erechtheion	properNoun
learn to walk	apprendre à marcher	properNoun
Kaykan	Kaycan	properNoun
Alstom	Alstom	properNoun
Marjanco	Marjanco	properNoun
Batina	Batina	properNoun
Sevko	Sevko	properNoun
Halkidiki	Halkidiki	properNoun
Petrossian	Pétrosan	properNoun
Rashed	Imbécile	properNoun
Pasman	Pasman	properNoun
Taismary	Erismary	properNoun
Sabanc	Sabrd	properNoun
Vurgund	Vigueur	properNoun
Medunjanin	Medunjanin	properNoun
Labudovic	Labudovic	properNoun
Danko	Danko	properNoun
Vizek	Vizek	properNoun
Hozic	Hozic	properNoun
Udo	Tu fais	properNoun
Ferhadija	Ferhadija	properNoun
Rama	Rama	properNoun
Celtiksuyu	Celtiksuyu	properNoun
Evet	S'éviger	properNoun
Neftgazinkor	Neftgazinkor	properNoun
Razel	Rasoir	properNoun
Dilaver	Dilaver	properNoun
Fizulic	Fizulique	properNoun
Pini	Pini	properNoun
Tsikaridis	Tsikaridis	properNoun
Varlier	Varléchissant	properNoun
Mercouri	Mercouri	properNoun
Kornezov	Kornezov	properNoun
Obrad	Obraad	properNoun
Schela	Schela	properNoun
Bourzat	Bourzat	properNoun
Arvizu	Arvizu	properNoun
Neve	Neve	properNoun
Halil	Halil	properNoun
Spaska	Spaska	properNoun
Bjelakovic	Bjelakovic	properNoun
Eurojust	Euros	properNoun
Guzeldere	Guzeldere	properNoun
Humo	Humo	properNoun
Buika	Bika	properNoun
Ciuperca	Ciuperca	properNoun
Whun	Courir	properNoun
Bjeljina	Bijeljina	properNoun
Senel	Tirail	properNoun
Dian	Dian	properNoun
Kuzman	Kuzman	properNoun
Kruzel	Kruzel	properNoun
Hibic	Hibique	properNoun
Pantic	Pédé	properNoun
Ildem	Ildem	properNoun
Poudade	Pudade	properNoun
Holovaty	Holovaty	properNoun
Info	Info	properNoun
Sabih	Sabih	properNoun
Laden	chargé	adjective
Laden	en pleine charge	adjective
Laden	Chargé	None
Hesham	Hesham	properNoun
Gearity	Végétalité	properNoun
four-year	quatre ans	properNoun
Talanga	Talanga	properNoun
Sabor	Sabor	properNoun
Shkumbin	Shkumbin	properNoun
Qureia	QUREIA	properNoun
Falsoni	Falsoni	properNoun
Telalian	Télalian	properNoun
Rakovce	Rakovce	properNoun
Ritsos	Ritsos	properNoun
Maglic	Magnifique	properNoun
Zogiani	Zogiani	properNoun
Nard	le nard	noun
Nard	Nard	None
Iasi	Iasi	properNoun
Tineretului	Tineretului	properNoun
Konstandina	Kontandina	properNoun
Gunjaca	Gunjaca	properNoun
Teokarevic	Teokarevic	properNoun
Bogojevo	Bogojevo	properNoun
Chania	Chanie	properNoun
Filori	Filori	properNoun
Fantanele	Fantaisie	properNoun
Nese	Nese	properNoun
Shurdhi	Shurdhi	properNoun
Puiu	Puiu	properNoun
Seitan	Seitan	properNoun
Fraiteve	Fraîcheur	properNoun
Loekke	Loekke	properNoun
Polan	Polan	properNoun
Mihaela	Mihaela	properNoun
Mesarovic	Mésarovic	properNoun
Alashka	Alashka	properNoun
Orascom	Orascom	properNoun
Roskovec	Roskovec	properNoun
Emirgan	Émirgan	properNoun
Iblid	Iblid	properNoun
Baša	Baša	properNoun
Mouriki	Mouriki	properNoun
Alpan	Alpan	properNoun
Proll	Sucer	properNoun
Terra	Terra	properNoun
Sekuljica	Sekuljica	properNoun
Wintershall	Wintershall	properNoun
Ahmetaj	Ahmetaj	properNoun
DiCarlo	Dicarlo	properNoun
Cevik	Cevik	properNoun
Cincur	convenir	verb
Cincur	concorder	verb
Cincur	se collaborer	verb
Cincur	être d'accord	verb
Cincur	Convenir	None
Lufti	Lufti	properNoun
Pecs	Pecs	properNoun
Laas	Laas	properNoun
Altan	Altan	properNoun
Harns	Harns	properNoun
Ejdus	Ejdus	properNoun
Kamalmaz	Kamalmaz	properNoun
Erdelji	Erdelji	properNoun
Sergan	Sergent	properNoun
Photiadis	Photadis	properNoun
Grecotel	Grecotel	properNoun
Sidski	Sidski	properNoun
Delpy	Delpy	properNoun
Comert	Vomir	properNoun
Fouere	Fouerère	properNoun
Muntenia	Muntenia	properNoun
Vike	Vélo	properNoun
Vidin	Vidin	properNoun
Krnovo	Krnovo	properNoun
Markt	Marquage	properNoun
Besjan	Besjan	properNoun
Gitenstein	Gitenstein	properNoun
Saadet	Saadet	properNoun
Kniewald	Cavalier	properNoun
Shefqeti	Shefqeti	properNoun
Kovaci	Kovaci	properNoun
Kresal	Kresal	properNoun
Kvarner	Kvarner	properNoun
Bors	Bors	properNoun
Uslu	Uslu	properNoun
Voulgarakis	Voulgarakis	properNoun
Koukas	Koukas	properNoun
Kavaje	Kavaje	properNoun
Hamgyong	Hamgyong	properNoun
Sadogatake	Sadogake	properNoun
KazTransGas	Kaztransgas	properNoun
Milievic	Méchant	properNoun
Iuliu	Iuliu	properNoun
Pijesak	Pijesak	properNoun
Dhimiter	Dhimiteur	properNoun
Vahidin	Vahidin	properNoun
Scaramella	Scaramella	properNoun
Iznik	Iznik	properNoun
Lazarescu	Lazarescu	properNoun
Kalkan	Kalkan	properNoun
Cambiasso	Cambicies	properNoun
Celibashi	Celibashi	properNoun
Lazer	Lazer	properNoun
Rogac	Rogac	properNoun
Gevorgian	Gevorgien	properNoun
Isa	Est un	properNoun
Piyade	Piyade	properNoun
Faruk	Futuk	properNoun
Lefter	Librelet	properNoun
Stojan	Stojan	properNoun
Bevanda	Bevanda	properNoun
Shumen	Chou	properNoun
Mitevska	Mitevska	properNoun
Metchnikoff	Metchnikoff	properNoun
Krka	Krka	properNoun
Herta	Herta	properNoun
Vaseler	Vaseler	properNoun
Hilmo	Hilmo	properNoun
Huffington	Huffington	properNoun
Krombrouguet	Krombouguet	properNoun
Franchini	Franchini	properNoun
pass away	passer	verb
pass away	décéder	verb
pass away	disparaître	verb
pass away	mourir	verb
pass away	trépasser	verb
pass away	s'éteindre	verb
pass away	mourir	None
Movieplex	Cinéma	properNoun
Aristeion	Aristéion	properNoun
Sannino	Sannino	properNoun
Leoncavallo	Leoncavallo	properNoun
Artchitects	Architectes	properNoun
Koznick	Koznick	properNoun
Henk	Henk	properNoun
Batrovci	Batrovci	properNoun
Votanikos	Votanikos	properNoun
Hilmi	Hilmi	properNoun
Budisa	Budmisa	properNoun
Lennox	Lennox	properNoun
Ilkova	Ilkova	properNoun
Kilian	Kilian	properNoun
Frangaj	Frangaj	properNoun
Atalar	Atalar	properNoun
Santoro	Santoro	properNoun
Imrali	Imali	properNoun
Barham	Barham	properNoun
Gurria	Groïde	properNoun
Maragoula	Maragoula	properNoun
Naaman	Naaman	properNoun
Jilmaz	Jilmaz	properNoun
Preporod	Préparateur	properNoun
Langer	Langer	properNoun
Olabiyi	Olabiyi	properNoun
Zabeni	Zabeni	properNoun
Lahm	Lahm	properNoun
Mrksic	Mrksic	properNoun
Dretta	Drlette	properNoun
Kounis	Kounis	properNoun
Madame	las Madame	noun
Madame	Madame	None
Tayfun	Tayfun	properNoun
Oslobodjenje	Oslobodjenje	properNoun
Lenzerheide	Lenzerheide	properNoun
Sanjaagiin	Sanjaagiin	properNoun
Michelakis	Michelakis	properNoun
Iliyana	Iliyana	properNoun
Tarasouleas	Tarasouleas	properNoun
Hrus	Hrus	properNoun
Lakaica	Lakaica	properNoun
Rankovic	De Rankovic	properNoun
Iliopoulos	Iliopoulos	properNoun
Pimen	Pimen	properNoun
Tudorica	Tudorica	properNoun
Birlesik	Birlesik	properNoun
Stavileci	Stavileci	properNoun
Halepas	Hallaques	properNoun
Prevezi	Prévisi	properNoun
Krsko	Krsko	properNoun
Erucu	Eruci	properNoun
Lorna	Lorna	properNoun
Citibank	Citibank	properNoun
Mudresa	Mudresa	properNoun
Dubreiul	Dubreuil	properNoun
Sevdimov	Sevdimov	properNoun
Bugojno	Bugojno	properNoun
Luli	Luli	properNoun
Kurokawa	Kurokawa	properNoun
Lenk	Lenk	properNoun
Evin	El filtre	properNoun
Dankvert	Étanguer	properNoun
Feraje	Feraje	properNoun
Atticus	Atcitus	properNoun
Elghandour	Elghandour	properNoun
Antonios	Antonios	properNoun
Raed Arafat	Raed Arafat	properNoun
Pekovic	Pekovic	properNoun
Pertuan	Peruré	properNoun
Mazniku	Mazniku	properNoun
Menounos	Ménounous	properNoun
Diossy	Diosseux	properNoun
in spite of that	malgré ça	properNoun
Mesud	Méseu	properNoun
Aljo	Aljo	properNoun
Benda	Benda	properNoun
Kerstic	Kerstique	properNoun
Milojko	Milojko	properNoun
Kalanj	Kalanj	properNoun
Umran	Umran	properNoun
Petnjica	Petnjica	properNoun
Horia	Horia	properNoun
Duckworth	Duckworth	properNoun
Enyeart	Enyeart	properNoun
Godzo	Godzo	properNoun
Toomas	Toomas	properNoun
Vicentijevic	Vicenti-avic	properNoun
Raimo	Raimo	properNoun
Poste	Pose	properNoun
Romuliana	Romuliana	properNoun
Iastrebcheak	Iastrebcheak	properNoun
EUpolitix	Eupolitix	properNoun
Bahceli	Bahceli	properNoun
Annan	Annan	properNoun
Muammar	Muammar	properNoun
Nexium	Nexium	properNoun
Dumnica	Dumnica	properNoun
Nadj	Nadj	properNoun
Pernaska	Pernaska	properNoun
Afgan	Afgane	properNoun
Chunfeng	Chunfeng	properNoun
Siskov	Siskov	properNoun
Hatzinikolaou	Hatzinikolaou	properNoun
Mikolaj	Mikolaj	properNoun
Slavan	Slavan	properNoun
Dordije	Dordije	properNoun
Botos	Botos	properNoun
Cakici	Cakici	properNoun
Neshkov	Neshkov	properNoun
Kerum	Kérum	properNoun
triumph over	triompher	properNoun
Mircea	Mircea	properNoun
Nemtoi	Nemtoi	properNoun
Ozant	Ozant	properNoun
Borisovo	Borisovo	properNoun
Zeitung	Zeitung	properNoun
Buyuk	Buyuk	properNoun
Pratibha	Pratitibha	properNoun
Bogdani	Bogdani	properNoun
Adla	Adla	properNoun
Goergl	Goegl	properNoun
Zhulali	Zhulali	properNoun
Istiklal	Istiklal	properNoun
Maroje	Maroje	properNoun
Seker	Seker	properNoun
Egitim	Égalité	properNoun
Dogu	Dogu	properNoun
Graeco	Graeco	properNoun
Nedjmedin	Nedjmedin	properNoun
Tasho	Tasho	properNoun
Stanila	Stanila	properNoun
Gorbunov	Gorbunov	properNoun
Havelsan	Havelsan	properNoun
Abaz	Abaz	properNoun
Blendi	Blendi	properNoun
Vuka	Vuka	properNoun
Plitvice	Pliette	properNoun
Dejes	Djes	properNoun
the majority of	la majorité des	properNoun
Muhedini	Muhedini	properNoun
Rambo	Radin	properNoun
Devisingh	Concevoir	properNoun
Naile	Cloué	properNoun
Tellas	Tellas	properNoun
Groenefeld	Groenefeld	properNoun
Niculae	Nénula	properNoun
Holger	Holigneur	properNoun
Katsiadakis	Katsiadakis	properNoun
Beqaj	Beqaj	properNoun
Bertil	Bertille	properNoun
Nagylak	Nagylak	properNoun
Dromey	Dromey	properNoun
Luxardo	Luxardo	properNoun
Bjelajac	Bjelajac	properNoun
Hasim	Ha sim	properNoun
Skupi	Skupi	properNoun
Vessela	Vessela	properNoun
Backi	Backi	properNoun
Raciti	Raciti	properNoun
Lefkolithos	Lefkolithos	properNoun
Recura	Recura	properNoun
Alem	Alem	properNoun
Decressin	Décressin	properNoun
Tatons	Tatons	properNoun
Acev	Acev	properNoun
Xenakis	Xenakis	properNoun
Cernavoda	Cernavoda	properNoun
Gaudeamus	Gaudeamus	properNoun
Sidran	Sidran	properNoun
Sijakovic	Sijakovic	properNoun
Makriyanni	Makriyanni	properNoun
Stradivarius	Stradivarius	properNoun
Arjana	Arjana	properNoun
Onal	Alternatif	properNoun
Mittel	Mittel	properNoun
Avaz	Avau	properNoun
Vejnovic	Vejnovic	properNoun
Altius	Altius	properNoun
Sinj	Sinj	properNoun
Kostova	Kostova	properNoun
Hajradini	Hajradini	properNoun
Pekaz	Pekaz	properNoun
Inspectorate	le corps des inspecteurs	noun
Inspectorate	Inspection	None
Gumusdal	Gamusdal	properNoun
Aselsan	ASELSAN	properNoun
Paraskevaidion	Paraskevaidion	properNoun
Swissport	Swissport	properNoun
Horacek	Horacek	properNoun
Sali	Sali	properNoun
Metsikoff	Metsikoff	properNoun
see through	voir à travers	verb
see through	mener à bonne fin	verb
see through	comprendre	verb
see through	voir à travers	None
Kotromanic	Kotromanique	properNoun
Viara	Vara	properNoun
Zanka	Zanka	properNoun
Nikos	Nikos	properNoun
Borka	Borka	properNoun
Petrosani	Pétrosani	properNoun
Vidovdan	Vidovdan	properNoun
Salikovic	Salikovic	properNoun
Rudine	Rugissement	properNoun
Muharrem	Muharrem	properNoun
Miroljub	Miroljub	properNoun
Heinz	Heinz	properNoun
Karageorghis	Karageorghis	properNoun
Gica	Gica	properNoun
Merisa	Merisa	properNoun
Touqan	Touqan	properNoun
Macelj	Macelj	properNoun
Gavrias	Gavrias	properNoun
Grzybek	Grozebek	properNoun
Skandalidis	Skandalidis	properNoun
Saadi	Saadi	properNoun
Kassar	Kassar	properNoun
Morava	Morva	properNoun
Afyon	Afyon	properNoun
Tezdzhan	Tezdzhan	properNoun
Tuzi	Tuzi	properNoun
Suljagic	Suljagique	properNoun
Hingis	Hingis	properNoun
Bonev	Bazar	properNoun
Savvides	Savvides	properNoun
Ahrenkilde	Ahrenkilde	properNoun
Saptamina	Saptamina	properNoun
UralSib	Urale	properNoun
Krtolin	Krtolin	properNoun
Egira	Egira	properNoun
Haarde	Haarde	properNoun
Akakios	Akakios	properNoun
Misko	Misko	properNoun
Ingo	Ingo	properNoun
Lomon	Lomon	properNoun
Stader	Stader	properNoun
Knapen	Cognacen	properNoun
Kwame	Kwame	properNoun
Deda	Deda	properNoun
Oleh	Oleh	properNoun
Mustajbegovic	Mustajbegovic	properNoun
Levant	le Levant	noun
Levant	Levant	None
Dorevski	Dorevski	properNoun
Nabih	Nabih	properNoun
Sisli	Sisli	properNoun
Kocaoglu	Kocaoglu	properNoun
Venelin	Veneline	properNoun
Shukri	Shukri	properNoun
Voineagu	Vœu	properNoun
Troullia	Troullia	properNoun
Novoberde	Novoberde	properNoun
Corvell	Corvell	properNoun
Speroni	Speroni	properNoun
Stefka	Stefka	properNoun
Vrajolli	Vrajolli	properNoun
Bugdayci	Bugdayci	properNoun
Festus	Festus	properNoun
Hara	Hara	properNoun
Maksic	Maksique	properNoun
Marginean	Margeen	properNoun
Vekaric	Vekaric	properNoun
Hysen	Hystan	properNoun
Lunacek	Lunacek	properNoun
Lugonja	Lugonja	properNoun
Remiglio	Remiglio	properNoun
Magelli	Magelli	properNoun
Zlatar	Zlatar	properNoun
Urcan	Urcan	properNoun
Ramljak	Ramljak	properNoun
Grcec	Grecque	properNoun
Spillover	Revêtement	properNoun
Strba	Strabisme	properNoun
Zupancic	Zupancique	properNoun
Neda	Neda	properNoun
Kljestan	Kljestan	properNoun
Ackovic	Ackovic	properNoun
Darinko	Darko	properNoun
Swarup	Agression	properNoun
Maksimir	Maksimir	properNoun
Streamoil	Streamoil	properNoun
Eqerem	Eqerem	properNoun
Sorafenib	Sorafénib	properNoun
Lati	Lati	properNoun
Mitko	Mitko	properNoun
Nebojša	Nebojša	properNoun
Viva	Vive!	interjection
Viva	Vivat!	interjection
Viva	Viva	None
Carsija	Carsija	properNoun
Kilibarda	Kilibarda	properNoun
Macan	Macan	properNoun
Sebahat	Sebahat	properNoun
Pascu	Fouet	properNoun
Alatnica	Alatinica	properNoun
Premysl	Prémysl	properNoun
Milinko	Milinko	properNoun
Baulovski	Baulovski	properNoun
Seculici	Séculici	properNoun
Hakkari	Hakka	properNoun
Gulden	Grognon	properNoun
Bashkim	Bashkim	properNoun
Gallipolis	Gallipolis	properNoun
Genzano	Genzano	properNoun
Sidik	Sidik	properNoun
Strandzha	Strandzha	properNoun
Bechev	Bechev	properNoun
Gusla	Gusla	properNoun
Suljo	Suljo	properNoun
Merdanoglu	Merdanoglu	properNoun
Lungov	Lungov	properNoun
Lirici	Lirici	properNoun
Pipkov	Pipkov	properNoun
Bhagwati	Bhagwati	properNoun
Dundo	Duno	properNoun
Hidanovic	Hidanovic	properNoun
Bio	Bio	properNoun
Snagov	Snagov	properNoun
Cementarnica	Cemenernica	properNoun
Letrem	Letrem	properNoun
Tomihiro	Tomihiro	properNoun
Demiroren	Démirorien	properNoun
Barnier	Plus grêle	properNoun
Bergan	Bergan	properNoun
Gelsenkirchen	Gelsenkirchen	properNoun
Zeppelin	le zeppelin	noun
Zeppelin	Zeppelin	None
Kittlitz	Kittlitz	properNoun
Eurimage	Eurimage	properNoun
Melisses	Mélissaire	properNoun
Zgela	Zgela	properNoun
Manesis	Manéité	properNoun
Poci	Poci	properNoun
Sova	Sova	properNoun
Ciarla	Ciarla	properNoun
Klovicevi	Klovicevi	properNoun
Grabar	Grognon	properNoun
Panasonic	Panasonique	properNoun
Taton	Taton	properNoun
Ghiona	Ghiona	properNoun
Prodani	Prodani	properNoun
Bagci	Baguette	properNoun
Kristalina	Kristalina	properNoun
Karaalsan	Karaleal	properNoun
Niki	Niki	properNoun
Metaxas	Métaxes	properNoun
Domineco	Domineco	properNoun
Poljoprivredna	Poljoprivredna	properNoun
Kena	Kena	properNoun
Prix	Prix	properNoun
anti-European	anti-européen	properNoun
Kucukciftlik	Kucukciftlik	properNoun
Drom	Droguer	properNoun
Bahattin	Bahattin	properNoun
Twestival	Ombre	properNoun
Polanca	Polanco	properNoun
Miklos	Miklos	properNoun
Gokhan	Gokhan	properNoun
Vizionit	Vizionit	properNoun
Mihajlo	Mihajlo	properNoun
Hasari	Hasari	properNoun
Esra	Esra	properNoun
Skenderaj	Skenderaj	properNoun
Tariceanu	Taceanu	properNoun
Causidis	Causidis	properNoun
Levinski	Levinski	properNoun
Masin	Maçonner	properNoun
Krimo	Krimo	properNoun
Piriler	Piriler	properNoun
Holbrooke	Holbrooke	properNoun
Cipa	CIPA	properNoun
Radomirski	Radomirski	properNoun
Condescu	Condès	properNoun
Obersnel	Obersnel	properNoun
Lipcani	Lipcani	properNoun
self awareness	connaissance de soi	properNoun
Izvorul	Izvorul	properNoun
Svetko	Svetko	properNoun
Alessia	Alessie	properNoun
Papazov	Papazov	properNoun
Zaqishta	Zaqishta	properNoun
Euroatom	Euratom	properNoun
Dimcovski	Dimcovski	properNoun
Galenika	Galénika	properNoun
Koroman	Korman	properNoun
Panait	Panait	properNoun
Mejdi	Mejdi	properNoun
Et	ET	properNoun
Mower	la tondeuse	noun
Mower	le faucheur	noun
Mower	Tondeuse	None
Atelje	Atelje	properNoun
Malgorzate	Malgorzate	properNoun
Nitekst	Nitekst	properNoun
Arbnora	Arbnora	properNoun
Kader	Kader	properNoun
Kaptanoglu	Kaptanoglu	properNoun
Cotidianul	Cotidianul	properNoun
Ilirjana	Ilirjana	properNoun
Rahoveanus	Rahoveanus	properNoun
Gordana	Gordana	properNoun
Vecernje	Vecernje	properNoun
Scriabin	Scinabine	properNoun
Bogranovic	Bogdanovic	properNoun
Papadoniou	Papadoniou	properNoun
Arunovic	Arunovic	properNoun
Iljoski	Iljoski	properNoun
Veljkovic	Veljkovic	properNoun
Magurele	Magurele	properNoun
Blato	Blato	properNoun
Primakov	Primakov	properNoun
Ulyskog	Ulyskog	properNoun
Koliqi	Koliqi	properNoun
Antikythera	Antiquythé	properNoun
Deutsche Welle	Deutsche Welle	properNoun
Ekici	Ekici	properNoun
Ilkay	Ilkay	properNoun
Simeon	Simulateur	properNoun
Linz	Linz	properNoun
Deve	Se remettre	properNoun
Boyukliev	Boyukliev	properNoun
Tesiu	Tesiu	properNoun
Elinden	Elinden	properNoun
Milenko	Milenko	properNoun
Grecu	Grecu	properNoun
Edip	EDIP	properNoun
Ramikovic	Ramikovic	properNoun
Turkish	turc	adjective
Turkish	le turc	noun
Turkish	le Turc	noun
Turkish	Turc	None
Andoni	Andoni	properNoun
Calignano	Caligno	properNoun
Etnoland	ETNOLAND	properNoun
Rudnap	Rudnap	properNoun
Wiersma	Wiersma	properNoun
Kallikratis	Kallikratis	properNoun
Demetris	Démétris	properNoun
Efremova	Efremova	properNoun
Kahramanmaras	Kahramanmaras	properNoun
Brelak	Brelak	properNoun
Krems	Krems	properNoun
Gaina	Gain	properNoun
Pomoravlje	Pomoravlje	properNoun
Varosha	Varosha	properNoun
Astrium	Astrium	properNoun
Lekatsas	Lekatsas	properNoun
Brdo	Bretelle	properNoun
Vidojkovic	Vidojkovic	properNoun
Malki	Malki	properNoun
Suf	Suf	properNoun
Dorit	Dorit	properNoun
Cavusoglu	Cavusoglu	properNoun
Bajevic	Bajevic	properNoun
Safet	Sauf	properNoun
Nurgaliev	Nurgaliev	properNoun
Desanka	Dessein	properNoun
Prisma	Prisma	properNoun
Tilev	Tilev	properNoun
Morana	Morana	properNoun
Efedaki	Efedaki	properNoun
Stajic	Stajic	properNoun
Presevo	Presevo	properNoun
Roucham	Roucher	properNoun
Aramii	Aramii	properNoun
Tsonchev	Tsonchev	properNoun
Haki	Haki	properNoun
Premio	Premio	properNoun
within weeks	dans quelques semaines	properNoun
Nasip	Nasip	properNoun
Dragusha	Dragusha	properNoun
Serhan	Serhan	properNoun
Graniti	Graniti	properNoun
Kypris	Kypris	properNoun
Bosilovo	Bosilovo	properNoun
Chopra	Chopra	properNoun
Vasilic	Vasilique	properNoun
Schwimmer	Schwimmer	properNoun
Ortev	Ortev	properNoun
Modreanu	Modreanu	properNoun
Rubiku	Rubiku	properNoun
Eyupoglu	Eyupoglu	properNoun
Medan	Médan	properNoun
Avdullah	Avdullah	properNoun
Katlanovo	Katlanovo	properNoun
AdriaMed	Adriamed	properNoun
Brodosplit	Brodosplit	properNoun
Mermeren	Smermeren	properNoun
Fjolla	Fjolla	properNoun
Rakel	Rakel	properNoun
Dechko	Déchko	properNoun
Glyndwr	Glyndwr	properNoun
Fila	Fila	properNoun
Arad	Aré	properNoun
Couloumbis	Couloumbe	properNoun
Volage	Volage	properNoun
Mein	Mein	properNoun
Guericke	Guericke	properNoun
Burazerovic	Burazerovic	properNoun
Plodine	Pliale	properNoun
Nena	Néné	properNoun
Enka	Enka	properNoun
Dung	la crotte	noun
Dung	engraisser par crotte	verb
Dung	Bêtises	None
Roder	Roder	properNoun
Minja	Minja	properNoun
Maystorov	Maystorov	properNoun
Stevchevski	Stevchevski	properNoun
Gusevski	Gusevski	properNoun
Emzarios	Emzarios	properNoun
Novorossiysk	Novorossiysk	properNoun
D	le ré	noun
D	ré	None
Monohoro	Monohoro	properNoun
Ersan	Ersan	properNoun
Koha	Koha	properNoun
Marabella	Marabella	properNoun
Agic	Agicole	properNoun
Porte	Portée	properNoun
Dmytro	Dmytro	properNoun
Engelbert	Engelbert	properNoun
Agrovin	Agrovin	properNoun
Desai	Desai	properNoun
Lefkada	LEFKADA	properNoun
Bjelovar	Bjelovar	properNoun
Marinus	Marinus	properNoun
Gazpromexport	Gazpromexport	properNoun
Grigoriadis	Grigoriadis	properNoun
Eptalofos	Eptalofos	properNoun
Sarksyan	Sarksyan	properNoun
Mayak	Madeak	properNoun
Picari	Picari	properNoun
Burunciuc	Buruncieu	properNoun
Taulant	Télamant	properNoun
Songul	Longeron	properNoun
Poutainen	Poutaren	properNoun
Susnjara	Susnjara	properNoun
Muco	Muco	properNoun
Bjelica	Bjelica	properNoun
Primato	Primato	properNoun
Boroume	Boroume	properNoun
Partibrejkiters	Partibrejkers	properNoun
Sawers	Scieurs	properNoun
Xanthopoulos	Xanthopoulos	properNoun
Perimenis	Périmenis	properNoun
Telsim	Telsim	properNoun
Divjaka	Divjaka	properNoun
Sheremet	Sheremet	properNoun
Valide	Valide	properNoun
Mersin	Mersin	properNoun
Algan	Alganesse	properNoun
Saljic	Saljic	properNoun
Verica	Verica	properNoun
begin waiting	commencer à attendre	properNoun
Gojer	Gojer	properNoun
Bogorodica	Bogorodica	properNoun
Schwazer	Schwazer	properNoun
Halk	Halk	properNoun
Kriz	Kriz	properNoun
Kasimdzhanov	Kasimdzhanov	properNoun
Altmann	Altmann	properNoun
Tirgu	Tirgu	properNoun
outside of	en dehors de	properNoun
Ndreca	Ndeca	properNoun
Neritan	Néritable	properNoun
Deskoska	Deskoska	properNoun
Hayrunnisa	Hayrunnisa	properNoun
Takahara	Takahara	properNoun
Kaletovic	Kaletovic	properNoun
Parnassus	le Parnasse	noun
Parnassus	Parnasse	None
Vesilin	Vesilin	properNoun
Tivibu	Tivibu	properNoun
Pikermi	Pikerori	properNoun
Imerisia	Imerisie	properNoun
Balkanika	Balkanika	properNoun
Makfax	Makfax	properNoun
Nicoleta	Nicoleta	properNoun
Maar	Maar	properNoun
Metju	METJU	properNoun
Dej	Dej	properNoun
Davorko	Davorko	properNoun
Papanopi	Papanopi	properNoun
Niska	Niska	properNoun
Ardiana	Ardiana	properNoun
Kamberi	Kamberi	properNoun
Sanpaolo	Sanpaolo	properNoun
Peratikos	Pératikos	properNoun
Demetrious	Imbécile	properNoun
Trabzonsport	Trabzonspor	properNoun
Latakia	Lattakia	properNoun
Bricklin	Bricklin	properNoun
Donnersmarck	Donnersmarckk	properNoun
Vehabovic	Véhicules	properNoun
Pillay	Pilier	properNoun
Slavo	Slave	properNoun
Shekulli	Shekulli	properNoun
Velibor	Velibor	properNoun
Krizanec	Krizanec	properNoun
Lindita	Lindita	properNoun
Lazarova	Lazarova	properNoun
Dragoje	Dragoje	properNoun
Ludovic	Ludovic	properNoun
Fetai	Fétaï	properNoun
Nackov	Nackov	properNoun
Zletovo	Zletovo	properNoun
Timmermans	Timmermans	properNoun
Diklic	Diklique	properNoun
Siebenmann	Siebenmann	properNoun
Kharchenko	Kharchenko	properNoun
Helsinging	Helsingin	properNoun
Chaloupka	Chaloupka	properNoun
Verbund	Verbonnier	properNoun
Papoulias	Papoulias	properNoun
Badnjar	Badnjar	properNoun
visa-free	sans visa	properNoun
Hrbaty	Hrbaty	properNoun
Hatila	Hatila	properNoun
Scuri	Scuri	properNoun
Durmishi	Durmishi	properNoun
Dili	Dili	properNoun
Maslov	Maslov	properNoun
Mimica	Mimica	properNoun
Irig	Idiot	properNoun
Adnkronos	Adnkronos	properNoun
Nobel	Nobel	properNoun
Moller	Moller	properNoun
Shterpce	Éclater	properNoun
Erdem	Erdem	properNoun
Brodec	Brodec	properNoun
Zvezdakoski	Zvezdakoski	properNoun
Harun	Harun	properNoun
Malaele	Malaélien	properNoun
Agios	l' agio	noun
Agios	Agios	None
Petrotub	Pétrolier	properNoun
Dogulu	Dogulu	properNoun
Krknjas	Krknjas	properNoun
Vit	Vit	properNoun
Carom	le carambolage	noun
Carom	caramboler	verb
Carom	Carambolage	None
Focsani	Focsani	properNoun
Rassas	Rassas	properNoun
Grabovci	Grabovci	properNoun
Ciray	Ciray	properNoun
Oresteia	Orsteia	properNoun
Crne	Crné	properNoun
Automechanika	Automechanika	properNoun
Sharlandjieva	Sharlandjieva	properNoun
Brigham	Brigham	properNoun
faster	le jeûneur	noun
faster	plus rapide	None
Apoists	Apoisistes	properNoun
Tiga	Tiga	properNoun
Mosnews	Mosnews	properNoun
Nermin	Nermin	properNoun
Takis	Takis	properNoun
Cerna	CERNA	properNoun
Pazios	Pazios	properNoun
Ersoy	Ersoy	properNoun
Mister	le Monsieur	noun
Mister	l' héros	noun
Mister	le caïd	noun
Mister	Monsieur	None
Stephanopoulos	Stephanopoulos	properNoun
tank	le réservoir	noun
tank	la cuve	noun
tank	la citerne	noun
tank	le tank	noun
tank	le char	noun
tank	la bouteille	noun
tank	le blindé	noun
tank	la cellule	noun
tank	le coup	noun
tank	mettre en réservoir	verb
tank	Char	None
Arapi	Arapi	properNoun
Alper	Alpin	properNoun
Filic	Filiaque	properNoun
Sabiha	Sabiha	properNoun
Kinichi	Kinichi	properNoun
Behluli	Behluli	properNoun
Radenkovic	Radenkovic	properNoun
Fryma	Frym	properNoun
Dilbaz	Dilabaz	properNoun
Atanasoff	Atanasoff	properNoun
Antoniadou	Antoniadou	properNoun
Nerin	Nerin	properNoun
Shkeqim	Shkeqim	properNoun
Technobau	Technobau	properNoun
Hiotis	Hiottis	properNoun
Lahi	Lahi	properNoun
Karovic	Karovic	properNoun
Lapustesti	Lapustesti	properNoun
Dunum	Dunum	properNoun
Smalios	Smalios	properNoun
Skype	Skype	properNoun
Valaoritis	Valorite	properNoun
Ninic	Ninic	properNoun
Animus	l' animus	noun
Animus	Animus	None
Evzoni	Evzoni	properNoun
Ilijeva	Ilijeva	properNoun
Aleko	Aleko	properNoun
Hendal	Hendelin	properNoun
Alumil	Alumil	properNoun
Miona	Miona	properNoun
Samra	Samra	properNoun
Teliti	Teliti	properNoun
Zalata	Zalata	properNoun
Kinezos	Kinezos	properNoun
Edirne	Edirne	properNoun
Campeanu	Camanu	properNoun
Repic	Repiquer	properNoun
Bojana	Bojana	properNoun
Kexin	Kexin	properNoun
Rasmussen	Rasmussen	properNoun
Qesja	Qesja	properNoun
Nikolaos	Nikolaos	properNoun
Stambolov	Stambolov	properNoun
Vabres	Vaborer	properNoun
Firtina	Firtina	properNoun
Blues	la chanson noire triste	noun
Blues	Blues	None
Adamkus	Adamkus	properNoun
Sutjeska	SUTJESKA	properNoun
Yiannis	Yiannis	properNoun
Predrag	Prédrer	properNoun
Gokkan	Gokkan	properNoun
Wibute	Héberger	properNoun
Bocan	Bocan	properNoun
Clijsters	Clijsters	properNoun
Sekip	Sekip	properNoun
Mikulicic	Mikulicien	properNoun
Blerand	Blagand	properNoun
Omniasig	Omniasig	properNoun
Zastava	ZASTAVA	properNoun
Butel	Butel	properNoun
Erduan	Erduan	properNoun
Vankovska	Vankovska	properNoun
Bargala	Bargala	properNoun
Papaspyrou	Papasyrou	properNoun
Elmacik	Elmacik	properNoun
Hala	Halla	properNoun
Irini	Irini	properNoun
Republika	République	properNoun
Matelis	Matelis	properNoun
Kees	Queue	properNoun
Masic	Massif	properNoun
Lakovic	Lakovic	properNoun
persevere	persévérer	verb
persevere	persister	verb
persevere	persévérer	None
Kypros	Kypros	properNoun
take more than necessary	prendre plus que nécessaire	properNoun
Zletovica	Zletovica	properNoun
Zvezdno	Zevézdno	properNoun
Vilenica	Vilenica	properNoun
Vodusek	Vodusek	properNoun
Simidchiev	Simidiévier	properNoun
Arbil	Arbil	properNoun
Sianos	Sianos	properNoun
Avantasia	Avantasia	properNoun
Kristomir	Kristomir	properNoun
Harsova	Harsova	properNoun
Matlicis	Matlicis	properNoun
Gazeksport	Gémise	properNoun
Nikopol	Nikopol	properNoun
Kasimati	Kasimati	properNoun
Brannan	Brannan	properNoun
Shaqiri	Shaqiri	properNoun
Odobasic	Odobasique	properNoun
Necdet	Necdet	properNoun
Bordyuzha	Bordyuzha	properNoun
Leke	Leke	properNoun
Koc	Koc	properNoun
Ethnos	Ethnos	properNoun
Dodon	Dodon	properNoun
Abadzhiev	Abadzhiev	properNoun
Abolfazl	Abolfazl	properNoun
Karahanoglu	Karahanoglu	properNoun
Segesvar	Segesvar	properNoun
Urechean	Uréchète	properNoun
Rukic	Rukique	properNoun
Eutelsat	Eutelsat	properNoun
Aviorent	Aviorent	properNoun
Bilisht	Bilisht	properNoun
Whistler	Whistler	properNoun
Drmno	Drmno	properNoun
Gasinci	Gasinci	properNoun
Koroni	Koroni	properNoun
Berislav	Berislav	properNoun
Prosvjeta	Prosvjeta	properNoun
Akrata	Akrata	properNoun
Vasoje	Vasoje	properNoun
Ilievska	Ilievska	properNoun
Samsun	Samsun	properNoun
Beqa	Beqa	properNoun
Bogovinje	Bogovinje	properNoun
Cammeo	Cameo	properNoun
Kedev	Kedev	properNoun
Daum	Daum	properNoun
Nitchidorf	Nitchidorf	properNoun
Hayssam	Hayssam	properNoun
Korneychuk	Korneychuk	properNoun
Manousis	Manousse	properNoun
Croatiastocar	CroatiaStocar	properNoun
Poiana	Poignée	properNoun
Bjelashnica	Bjelasnica	properNoun
Aartsen	Aartsen	properNoun
Kalemi	Kalemi	properNoun
Tannock	Tancoquet	properNoun
Susurluk	Susurluk	properNoun
Lani	Lani	properNoun
Kammerhoff	Kammerhoff	properNoun
Beos	Beos	properNoun
Mahatma	Mahatma	properNoun
Ksenofon	Ksenofon	properNoun
Sestanovac	Sestanovac	properNoun
Habibi	Habibi	properNoun
Chrysohoides	Chrysohoides	properNoun
Fatos	Fatos	properNoun
Palea	Palea	properNoun
Kragujevac	Kragujevac	properNoun
Stimac	Stimuler	properNoun
Kamenica	Kamenica	properNoun
Crotale	Crotte	properNoun
Torbica	Torbica	properNoun
Konjufca	Konjufca	properNoun
Nikcevic	Nikcevic	properNoun
Hani	Hani	properNoun
Mencinger	Mencinger	properNoun
Hoti	Hotti	properNoun
Avdo	Avancé	properNoun
Tugui	Tugui	properNoun
Dolek	Dolek	properNoun
Holzhausen	Holzhausen	properNoun
Lenny	Lenny	properNoun
Thracean	Thraceen	properNoun
Hamaguchi	Hamaguchi	properNoun
Kolubara	Kolubara	properNoun
Sapna	Sapna	properNoun
Roma	Roma	properNoun
Serhat	Serhat	properNoun
Tagesspiegel	Tagesspiegel	properNoun
Vukov	Vukov	properNoun
Randjel	Randonnée	properNoun
Hodaj	Hodaj	properNoun
Houdek	Houdek	properNoun
Dautaj	Dautaj	properNoun
Laylat	Laïcs	properNoun
Bido	Bido	properNoun
Mollaj	Mollaj	properNoun
Bezmer	Bezmer	properNoun
Syzana	Syzana	properNoun
Fowlkes	Poubelle	properNoun
Specifar	Spécialiser	properNoun
Fogh	Fantaisie	properNoun
Curgus	Curgus	properNoun
Tumba	Timba	properNoun
Boer	boer	adjective
Boer	Boer	noun
Boer	boer	None
Kokan	Kokan	properNoun
Marije	Marije	properNoun
Becker	Becker	properNoun
Borenovic	Borenovic	properNoun
Rosandhaug	Rosandhaug	properNoun
Maca	Maca	properNoun
Europolitics	Europolitics	properNoun
Gorenjka	Gorenjka	properNoun
as an example	par exemple	properNoun
Miang	Miang	properNoun
Soukos	Soukos	properNoun
Harasteanu	Haraséanu	properNoun
Nortel	Nortel	properNoun
Seung	Seung	properNoun
Suisse	Suisse	properNoun
Kursumlija	Kursumlija	properNoun
Manaj	Manaj	properNoun
iron out	aplanir	verb
iron out	aplanir	None
Documenta	Documentaire	properNoun
Buhalis	Buhalis	properNoun
Banac	Banac	properNoun
Zagrebacka	Zagrebacka	properNoun
Graven	sculpté	adjective
Graven	taillé	adjective
Graven	Grave	None
Ivaylovgrad	Ivaylovgrad	properNoun
Demiri	Demiri	properNoun
Varotsos	Varotsos	properNoun
Koufodinas	Koufodinas	properNoun
Vukanic	Vicukanique	properNoun
Fiesta	Fiesta	properNoun
Sczporluk	Szporluk	properNoun
Ivesti	Ivesti	properNoun
Grozdanovska	Grozdanovska	properNoun
Atletico	Atletico	properNoun
Zorislav	Zorislav	properNoun
Račan	Račan	properNoun
Mithad	Mithad	properNoun
Manojlo	Manojlo	properNoun
Drazenko	Drazenko	properNoun
Tifesti	Ttifesti	properNoun
Stamatelou	Stamatelou	properNoun
Krushedol	Krushédol	properNoun
Ipko	IPko	properNoun
Holban	Holban	properNoun
Tatalovic	Tatalovic	properNoun
Goldfields	Champs d'or	properNoun
Apostolides	Apostolides	properNoun
Flushing	débusquer	verb
Flushing	rougir	verb
Flushing	nettoyer à grande eau	verb
Flushing	éclater	verb
Flushing	faire agiter	verb
Flushing	faire un élan	verb
Flushing	se montrer	verb
Flushing	reculer	verb
Flushing	Flushing	None
Interdeal	Interdien	properNoun
Berberoglu	Berberoglu	properNoun
Valentic	Valentitique	properNoun
Georgiou	Georgiou	properNoun
Trepca	Trepca	properNoun
Elsen	Elsen	properNoun
Semerdzhiev	Semerdzhiev	properNoun
Bolukbasi	Bolukbasi	properNoun
Fena	Fena	properNoun
Arici	Arici	properNoun
Veterovski	Véterovski	properNoun
Dedal	Déposer	properNoun
Shunsuke	Shunsuke	properNoun
Germanos	Germano	properNoun
Arelaga	Arelaga	properNoun
Tecau	Tecau	properNoun
Kaklamanakis	Kaklamakis	properNoun
Polina	Polina	properNoun
Morcheeba	Morcheeba	properNoun
Landale	Atterrir	properNoun
Vijay	Vijay	properNoun
Ristanovski	Ristanovski	properNoun
come to	se monter à	verb
come to	revenir à soi	verb
come to	venir à	None
Zhitkeyev	Zhitkeyev	properNoun
Vissi	Vissi	properNoun
Renate	Renoncer	properNoun
South-Eastern	Sud-est	properNoun
Trotter	le trotteur	noun
Trotter	les cheval de course	noun
Trotter	Trotteur	None
Zlotorowicz	Zlotorowicz	properNoun
Schonborn	Schonborn	properNoun
Falmur	Falmur	properNoun
Edhem	Edhem	properNoun
Taigaridis	Taigaridis	properNoun
Caslav	Caslav	properNoun
Cuk	Brutal	properNoun
Tsalikian	Tsalikian	properNoun
Kaptaner	Kaptanier	properNoun
Egzon	Egzon	properNoun
Saltzman	Salzeur	properNoun
Creditanstalt	CreditAnstalt	properNoun
Quirinale	Quirinale	properNoun
Staatkraft	Statistique	properNoun
Volynets	Volynets	properNoun
Gundem	Gundem	properNoun
Sahmanovic	Sahmanovic	properNoun
Simsir	Simsir	properNoun
Spoljaric	Spoljaric	properNoun
Nitya	Nitya	properNoun
Teoctist	Teoctiste	properNoun
Levent	Duvet	properNoun
Retzlaff	Retezlaff	properNoun
Aymar	Aymar	properNoun
Vrbovsko	Vrbovsko	properNoun
Cesur	Césur	properNoun
Agricole	Agricole	properNoun
Atakan	Atakan	properNoun
Conpet	Concept	properNoun
Sket	Sket	properNoun
Nikolin	Nikolin	properNoun
Nusaybin	Nusaybin	properNoun
Braniste	Braniste	properNoun
Vrabac	Vrabac	properNoun
Paduraru	Paduraru	properNoun
Rolf	Rolf	properNoun
Taulan	Taulan	properNoun
Dragobete	Dragobete	properNoun
Vashem	Vashem	properNoun
Bilbil	Bilbil	properNoun
Radulian	Radulien	properNoun
Etno	Etno	properNoun
Bohinjka	Bohinjka	properNoun
Filipova	Filipova	properNoun
Sofranac	Canofranac	properNoun
Serefli	Serefli	properNoun
Sorsa	Sorsa	properNoun
Zivulovic	Zivulovic	properNoun
Nakura	Nakura	properNoun
Milita	Milita	properNoun
Neckerman	Neckerman	properNoun
Eskici	Eskici	properNoun
Hitko	Hitko	properNoun
Bualoti	Bualoti	properNoun
Deniver	Deniver	properNoun
Valkanovska	Valkanovska	properNoun
Ilindenka	Ilindenka	properNoun
Dretelj	Dretelj	properNoun
Nicovic	Nicovic	properNoun
Milomir	Milomir	properNoun
Majdanpek	Majdanpek	properNoun
Cvrtil	Cvrtil	properNoun
Urmas	Urmas	properNoun
for a few weeks	Pendant quelques semaines	properNoun
Eronet	Érèves	properNoun
Baljinima	Baljinima	properNoun
Schygula	Schygulla	properNoun
Fabrikalari	Fabrikalari	properNoun
Radusa	Radusa	properNoun
Infosoft	Infosoft	properNoun
Stamou	Stamou	properNoun
Milje	Milj	properNoun
Gunter	Gunter	properNoun
Werkstatt	Werkstatt	properNoun
Strickland	Strickland	properNoun
Rudar	Rudar	properNoun
Divjak	Divaut	properNoun
Zulfu	Zulfu	properNoun
Ramstein	Ramstein	properNoun
Kuhar	Kuhar	properNoun
Kalimash	Kalimash	properNoun
Kolev	Kolev	properNoun
Amatör	Amatör	properNoun
Lucescu	Lucescu	properNoun
Idir	Idiot	properNoun
Prijepolje	Prijepolje	properNoun
Petrescu	Petresu	properNoun
Boyka	Boyka	properNoun
Pionir	Pionir	properNoun
Abizaid	Abizaid	properNoun
Sonje	Sonje	properNoun
Musavat	Musavat	properNoun
Tonino	Tonino	properNoun
Gorazd	Gorazd	properNoun
Suat	Suat	properNoun
Bosa	Bosa	properNoun
Bertelsmann	Bertelsmann	properNoun
turn down	refuser	verb
turn down	baisser	verb
turn down	rejeter	verb
turn down	rabattre	verb
turn down	descendre	verb
turn down	replier	verb
turn down	se fléchir	verb
turn down	refuser	None
Suzane	Suzane	properNoun
Sandov	Sandou	properNoun
Relja	Relja	properNoun
Mirosina	Mirosina	properNoun
Shinbao	Shinbao	properNoun
Chourea	Chouée	properNoun
Mandal	Mandal	properNoun
Hansjoerg	Hansjoerg	properNoun
Gazenica	Gazenica	properNoun
Kvaternik	Kvaternik	properNoun
Polk	Piquer	properNoun
Voggoli	Voggoli	properNoun
Prokopis	Prokopis	properNoun
Bajakovo	Bajakovo	properNoun
Promahon	PROMAHON	properNoun
Mondo	Mondo	properNoun
Veseli	Veseli	properNoun
Bijeljina	Bijeljina	properNoun
Wizz	Wizz	properNoun
Koulouris	Koulouis	properNoun
Kovljenic	Kovljenic	properNoun
Neum	Nier	properNoun
Gozde	Gozde	properNoun
Gungoren	Gungoren	properNoun
Rame	Rameau	properNoun
Recep	Réception	properNoun
Ozinan	Ozinan	properNoun
Manja	Manja	properNoun
Rubez	Rubéter	properNoun
Papuljas	Papuljas	properNoun
Lizdek	Lizdek	properNoun
Carkoglu	Carkoglu	properNoun
Guda	Guda	properNoun
Okutcu	Okutcu	properNoun
Antoniou	Antoniou	properNoun
Sanfey	Sanfey	properNoun
Savo	Savo	properNoun
Zotaj	Zotaj	properNoun
Sobota	Sobota	properNoun
Brada	Brada	properNoun
Skenderbe	Skenderbeu	properNoun
Felnac	Felnac	properNoun
buy out	acheter	properNoun
Blazo	Blazo	properNoun
Fili	Fili	properNoun
Darmstaedter	DARMSTAEDTER	properNoun
Victoriei	Victoriei	properNoun
Milev	Milev	properNoun
Takase	Takase	properNoun
Podgor	Podgor	properNoun
Karaliev	Karaliev	properNoun
Ceran	Céran	properNoun
Kanzovski	Kanzovski	properNoun
Bouka	Boue	properNoun
Dilo	Dilo	properNoun
Fien	Fideux	properNoun
Lutz	Lutz	properNoun
Samovodska	Samovodska	properNoun
Velesta	Velesta	properNoun
Ola	Ola	properNoun
Zoumboulakis	Zoumboulakis	properNoun
Kanun	Kanun	properNoun
Vardarski	Vardarski	properNoun
Cliveti	Cliveti	properNoun
Baraka	Baraka	properNoun
Fisnik	Fisnik	properNoun
Studenicani	Stunéicani	properNoun
Posta	Posta	properNoun
Vildan	Vildan	properNoun
Peshawar	Peshawar	properNoun
Kankaras	Kankaras	properNoun
Genk	Genge	properNoun
Norfish	Poisson-defrein	properNoun
Dreadzone	Dreadzone	properNoun
Shevchuk	Shevchuk	properNoun
Knut	Nœud	properNoun
Armco	Armoire	properNoun
Latakovac	Lattakovac	properNoun
Tandaric	Tangieux	properNoun
Sotirov	Sotirov	properNoun
Sallukh	Sallukh	properNoun
Magaza	Magazine	properNoun
Minz	Minez	properNoun
wizzard	wizzard	properNoun
Zeka	Zeka	properNoun
Bakevski	Bakevski	properNoun
Bohlen	Bohlen	properNoun
Marlies	Marlis	properNoun
Nefeli	Nefeli	properNoun
Ermira	Ermira	properNoun
Hadzidakis	Hadzidakis	properNoun
Linichuk	Linichuk	properNoun
Evian	Evian	properNoun
Klathmonos	Klathmonos	properNoun
Dren	Dren	properNoun
Kenteris	Kenteris	properNoun
Tacheva	Tacheva	properNoun
Makbule	Makbule	properNoun
Saravanja	Saravanja	properNoun
Damcevski	Damcevski	properNoun
Medulin	Méduline	properNoun
Ognjanovic	Ognjanovic	properNoun
Pavlopoulos	Pavlopoulos	properNoun
Lom	Lom	properNoun
Dalavecuras	Dalavecuras	properNoun
Shalabi	Shalabi	properNoun
Srejic	Srejic	properNoun
Brahem	Brahem	properNoun
Ozmen	Ozmen	properNoun
Brdjanin	Brodjanin	properNoun
Turgut	Turgut	properNoun
Detecon	Détecon	properNoun
Muriz	Murize	properNoun
Kolundzija	Kolundzija	properNoun
Prelic	Prélicieux	properNoun
Firtash	Firme	properNoun
Luchese	Lucchese	properNoun
Gotovina	Gotovina	properNoun
Vasiluta	Vasiluta	properNoun
Caglayan	Caglayan	properNoun
Cemal	Cémal	properNoun
Finvest	Furvest	properNoun
Platanos	Platanos	properNoun
Topolanek	Topolanek	properNoun
Mandza	Mandza	properNoun
Tianjin	Tianjin	properNoun
Tzadari	Tzadari	properNoun
Rupert	Rupert	properNoun
Kariman	Kariman	properNoun
Sako	Sako	properNoun
Boban	Boban	properNoun
Valiva	Valiva	properNoun
Rover	le vagabond	noun
Rover	nomade	noun
Rover	le vadrouilleur	noun
Rover	Vagabond	None
Papadimitriou	Papadimitriou	properNoun
Grubi	Grubi	properNoun
Clio	Clio	properNoun
Vamasescu	Vamasescu	properNoun
Koksal	Koksal	properNoun
Sonja	Sonja	properNoun
Antea	Anéanti	properNoun
BlogOpen	Blogopen	properNoun
Dumitra	Dumitra	properNoun
Biznesi	Biznesi	properNoun
Mervana	Mervana	properNoun
Apurna	Apna	properNoun
Paisy	Paisy	properNoun
Ebner	Ébeur	properNoun
Bubalo	Bubalo	properNoun
Aki	Aki	properNoun
Buxbaum	Buxbaum	properNoun
Sher	Sherque	properNoun
Ekim	Ekim	properNoun
Mbelek	Mbelek	properNoun
Kumrovec	Kumrovec	properNoun
Kornai	Kornai	properNoun
Mobikos	Mobikos	properNoun
Lauka	Lauka	properNoun
Zappella	Zappella	properNoun
Gundes	Gundies	properNoun
Capragovski	Capragovski	properNoun
Mentaz	Mentaz	properNoun
Gramoz	Gramoz	properNoun
Mento	Mento	properNoun
Kalicane	Kalicane	properNoun
Oakenfold	Oakenfild	properNoun
DigiTel	Digitel	properNoun
Agbas	Agbas	properNoun
Golan	Golan	properNoun
Laciner	Lacin	properNoun
Grizelj	Grizelj	properNoun
Plenkovic	Plenkovic	properNoun
Olaizula	Olaitizula	properNoun
Acda	Acda	properNoun
Basalic	Basalique	properNoun
Olgica	Olgica	properNoun
Paretzoglou	Paletzoglou	properNoun
Othman	Othman	properNoun
Peskov	Peskov	properNoun
Strumjani	Strumjani	properNoun
Elounda	Elounda	properNoun
Tisa	Tisa	properNoun
Trpinja	Trptinja	properNoun
Kellaria	Kellaria	properNoun
Vallee	Vallée	properNoun
Bergjani	Bergjani	properNoun
Bogovadja	Bogovadja	properNoun
Nesic	Nesic	properNoun
Verbovc	Verbovc	properNoun
Erkin	Erkin	properNoun
Sargsyan	Sargsyan	properNoun
Sohlström	Sohlström	properNoun
Iliopouli	Iliopouli	properNoun
Ivkova	Ivkova	properNoun
Dortkasli	Dortkasli	properNoun
Vefahan	Vefahan	properNoun
Magyar	magyar	adjective
Magyar	le Magyar	noun
Magyar	magyar	None
Tae	Tae	properNoun
Montenegroberza	Monténégoberza	properNoun
Gentry	la noblesse	noun
Gentry	la petite noblesse	noun
Gentry	les parents	noun
Gentry	Noblesse	None
Vermosh	Vermosh	properNoun
Khalilzad	Khalilzad	properNoun
Miuljenko	Miuljenko	properNoun
Stoichkov	Stoichkov	properNoun
Guenther	Guerther	properNoun
Londo	Londois	properNoun
Krajinovic	Krajinovic	properNoun
Mudrinic	Mudrinique	properNoun
Avrami	Avrami	properNoun
Aquapura	Aquapura	properNoun
Tiraspol	Tiiraspol	properNoun
Sarialp	Sarialp	properNoun
Deuric	Duuric	properNoun
Chertoff	Chertoff	properNoun
Philharmonic	philharmonique	adjective
Philharmonic	Philharmonique	None
Breznes	Breznes	properNoun
Nase	Nase	properNoun
Kuofos	Kuofos	properNoun
Abasiyanik	Abasiyanik	properNoun
Tafe	Tafe	properNoun
Dilovasi	Dilovasi	properNoun
Balikli	Balikli	properNoun
Derman	Derman	properNoun
Soyut	Sotonie	properNoun
Goodison	Bonneté	properNoun
dig in	fouiller	verb
dig in	creuser	None
Emek	Emek	properNoun
Mevlevihane	Mévlévihane	properNoun
Tehnika	Tehnika	properNoun
Hamzacebi	Hamzacebi	properNoun
Nasiha	Nasiha	properNoun
Zabela	Zabela	properNoun
Srdi	SRDI	properNoun
Bistrita	Bistrita	properNoun
Gormez	Gormez	properNoun
Phoenice	Phénice	properNoun
Kapllani	Kapllani	properNoun
Malsor	Malheur	properNoun
Euratom	Euratom	properNoun
Fahrudin	Fahrudin	properNoun
Grammata	Gramma	properNoun
Ekkehart	Ekkehart	properNoun
Sopta	Sopta	properNoun
Mermerler	Mmermerler	properNoun
Nakos	Nakos	properNoun
Acuner	Aculateur	properNoun
Kapisi	Kapisi	properNoun
Ceme	Ceme	properNoun
Dervishalidovic	Dervishalidovic	properNoun
Cucer	Cucer	properNoun
Fajront	Fajront	properNoun
Sayginer	Sayginer	properNoun
Husrev	Husrev	properNoun
Limak	Limer	properNoun
Zvecanska	Zvecanska	properNoun
Ardita	Ardita	properNoun
Paraskeva	Paraskeva	properNoun
Sremska	Sremska	properNoun
Padure	Cadrer	properNoun
Chemil	Chimiole	properNoun
Podgorica	Podgorica	properNoun
Basol	Basol	properNoun
Semsa	Semsa	properNoun
Stefarta	Stefarta	properNoun
Kiprotich	Kiprotich	properNoun
into consideration	en considération	properNoun
Gospoda	Gospoda	properNoun
Bajrami	Bajrami	properNoun
Djedovic	Djedovic	properNoun
Mobi	Mobi	properNoun
Tord	Tord	properNoun
Koptas	Koptas	properNoun
Geo	Géo	properNoun
Miljaim	Miljaim	properNoun
Ataturk	Ataturk	properNoun
Fotiou	Foti	properNoun
Gluhak	Gluhak	properNoun
Borbely	Borbely	properNoun
Travlos	Travistes	properNoun
Ritz	Ritz	properNoun
Cabej	Cabej	properNoun
Tsetska	Tsetska	properNoun
Kursad	Kursad	properNoun
Macon	Macon	properNoun
Envesa	Emvéa	properNoun
Faik	Faïk	properNoun
Opatija	Opatija	properNoun
Ramiqi	Ramiqi	properNoun
Menduh	Mendeuh	properNoun
Europetrol	Euro-anétrol	properNoun
Terzopoulos	Terzopoulos	properNoun
Limani	Limani	properNoun
Kung	Kung	properNoun
Zym	Zym	properNoun
Karev	Karev	properNoun
Stathis	Sathais	properNoun
Aslam	Aslam	properNoun
Schlaff	Schlaff	properNoun
Pridnestrovian	Pridnestrovien	properNoun
Mitschek	Mitschek	properNoun
Zharin	Zharin	properNoun
in comparison with	en comparaison avec	properNoun
Suites	Suites	properNoun
Muldur	Muldur	properNoun
Koleci	Koleci	properNoun
Brodksy	Brodsky	properNoun
Balkankan	Balkankan	properNoun
Spyridon	Spyridon	properNoun
Crnojevica	Crnojevica	properNoun
Sukosan	Sukosan	properNoun
Galya	Galya	properNoun
Sarno	Sarno	properNoun
Zeynep	Zeynep	properNoun
asked	demandé	properNoun
Grete	Grete	properNoun
Agbaba	Agbaba	properNoun
Distrigaz	Distrigaz	properNoun
Fortesa	Fortesa	properNoun
Azizoglu	Azizoglu	properNoun
Aladjem	Aladajem	properNoun
Gursel	Gursel	properNoun
Tunceli	Tunceli	properNoun
Zarka	Zarka	properNoun
Kalfa	Kalfa	properNoun
Ludbreg	Ludbreg	properNoun
Gramatikov	Gramatikov	properNoun
Allawi	ALLAWI	properNoun
Spanoulis	Spanoulis	properNoun
Matan	Matan	properNoun
Mitrovica	Mitrovica	properNoun
Aslanidis	Aslanidis	properNoun
Agaoglu	Agaoglu	properNoun
Teenarena	Teenarena	properNoun
Paloka	Paloka	properNoun
Sonompil	Sonompil	properNoun
DalmacijaVino	Dalmacijavino	properNoun
Bothorel	Poitrine	properNoun
Beka	Beka	properNoun
Bilogora	Bilogora	properNoun
Mazi	Mazi	properNoun
Cove	la crique	noun
Cove	l' anse	noun
Cove	le vallon encaissé	noun
Cove	las serine	noun
Cove	Crique	None
Cinkara	Cinkara	properNoun
Stamer	Étincelant	properNoun
Pendes	Pender	properNoun
Morine	Morne	properNoun
Grasso	Grassouillet	properNoun
Vladov	Vladov	properNoun
Turkstat	Turkstat	properNoun
Zehirovic	Zehirovic	properNoun
Samojko	Samojko	properNoun
Mitea	Mitea	properNoun
Laitenberger	Laitenberger	properNoun
Thaler	le thaler	noun
Thaler	Thaler	None
Gulhane	Gulhane	properNoun
Pankova	Pankova	properNoun
Tanov	Tanov	properNoun
Burchill	Burchill	properNoun
Kontinental	Kontinental	properNoun
Dyck	Dyck	properNoun
Kralj	Kralj	properNoun
Iliriana	Iliane	properNoun
Kirac	Kirac	properNoun
occurence	occurrence	properNoun
Tisch	Tisch	properNoun
Paphos	Paphos	properNoun
Akgul	Akgul	properNoun
Flutura	Flutura	properNoun
Pivara	Pivara	properNoun
Matyas	Mayas	properNoun
Tasovac	Tasovac	properNoun
Senta	Senta	properNoun
Harchenko	Harchenko	properNoun
Mugala	Mugala	properNoun
Cagaptay	Cagaptay	properNoun
Deniz	Denize	properNoun
Laszlo	Laszlo	properNoun
Dobric	Doté	properNoun
Cabernet	Cabernet	properNoun
Feulner	Feulner	properNoun
Domnina	Domnina	properNoun
Nazrul	Nazrul	properNoun
Nadja	Nadja	properNoun
Dalleres	Dalleres	properNoun
Caa	Caa	properNoun
Himenes	Himenes	properNoun
Gener	Générer	properNoun
Zovko	Zovko	properNoun
Cop	le flic	noun
Cop	le policier	noun
Cop	l' excuse	noun
Cop	le sommet	noun
Cop	arrêter	verb
Cop	Flic	None
Dimitropoulou	Dimitropoulou	properNoun
Rotaru	Rotoru	properNoun
Dardennes	Dardennes	properNoun
Aytun	Aytun	properNoun
Zap	Bing!	interjection
Zap	Zaper	None
Canyon	le canyon	noun
Canyon	la gorge	noun
Canyon	Canyon	None
Esti	Esti	properNoun
Geofoto	Géofoto	properNoun
Dilov	Dilov	properNoun
Corluka	Corluka	properNoun
Alket	Alpin	properNoun
Flourentzos	Florentzos	properNoun
Banco	Banco	properNoun
Gacanin	Gacanine	properNoun
Kogalniceanu	Kogalnicanu	properNoun
Akamai	Akamai	properNoun
Ziyatin	Ziyatin	properNoun
Traicho	Traicho	properNoun
Sarafovo	Sarafovo	properNoun
Sevinc	Sevinc	properNoun
Marmureanu	Marmureanu	properNoun
Ikarbus	Ikarbus	properNoun
Samast	Samast	properNoun
Agosto	Agosto	properNoun
Radanovic	Radanovic	properNoun
Nanos	Nanos	properNoun
Fondos	Fondos	properNoun
Aberuade	Aberuade	properNoun
Arif	Arif	properNoun
Techno	Techno	properNoun
Minarfa	Minarfa	properNoun
Zvornik	Zvornik	properNoun
Litomysl	Liomysl	properNoun
Purko	Purko	properNoun
Ksamili	Ksamili	properNoun
Stambolova	Stambolova	properNoun
Luko	Luko	properNoun
Inter	enterrer	verb
Inter	inhumer	verb
Inter	ensevelir	verb
Inter	Inter	None
Beriz	Beriz	properNoun
Fedarcyk	Fedarcyk	properNoun
Becej	Becej	properNoun
Levchev	Levchev	properNoun
Worldbulletin	WorldBulletin	properNoun
change form	changer de forme	properNoun
Hoxhati	Hoxhati	properNoun
Grozdana	Grozdana	properNoun
Bulgartransgaz	BulgaRansgaz	properNoun
Saimir	Saimir	properNoun
Bebler	Beurre	properNoun
Fakom	Fakom	properNoun
Navanethem	Navanéthem	properNoun
Avouris	Avoue	properNoun
Maisela	Maiselle	properNoun
Marinescu	Marinescu	properNoun
Kakome	Kakome	properNoun
Adamclisi	Adamclisi	properNoun
Bennike	Benne	properNoun
Kujtim	Kujtim	properNoun
Mruvkova	Mruvkova	properNoun
Girardelli	Girardelli	properNoun
Bizim	Bizim	properNoun
Vigan	Vigan	properNoun
Istog	Istog	properNoun
Mujo	Mujo	properNoun
Lipik	Lipik	properNoun
Ruci	Rui	properNoun
Raguz	Ragu	properNoun
Trajkov	Trajkov	properNoun
Tanriverdi	Tanriverdi	properNoun
Kilimanjaro	Kilimandjaro	properNoun
Tevez	Tevez	properNoun
Klasing	Klasing	properNoun
Saraliotis	Saraliotis	properNoun
Turandot	Turandot	properNoun
Wohlers	Wohlers	properNoun
Hoxhai	Hoxhai	properNoun
Dionyssos	Dionyssos	properNoun
Barenboim	Barboine	properNoun
Anthoussa	Anthoussa	properNoun
Podravska	Podravska	properNoun
Snezana	Snezana	properNoun
Astrit	Attraper	properNoun
Dumitrascu	DumiTascu	properNoun
Thana	Thana	properNoun
Bouckhaert	Bouckaert	properNoun
Turcas	Turcas	properNoun
Ilyana	Ilyana	properNoun
Ott	Ott	properNoun
Hrelja	Hrelja	properNoun
Hidroelektrika	Hidroelektrik	properNoun
Ynet	Ynet	properNoun
Marijana	Marijana	properNoun
Moica	Moica	properNoun
Vasif	Vasif	properNoun
Arjeta	Arjeta	properNoun
Mergim	Mergim	properNoun
Krijezi	Krijezi	properNoun
Gurcanli	Gurcanli	properNoun
Insaat	Insauser	properNoun
Turskat	Turskat	properNoun
Dragas	Dragas	properNoun
Marku	Marku	properNoun
Dragi	Dragi	properNoun
Artani	Artani	properNoun
Hebrang	Hébergement	properNoun
Kaas	Kaas	properNoun
Vlado	Vlado	properNoun
Parmalat	Parmalat	properNoun
Luchezar	Luchezar	properNoun
Bogdana	Boghana	properNoun
Leverkusen	LEVERKUSEN	properNoun
Hysni	Hystin	properNoun
Marincea	Marinçon	properNoun
Verka	Verka	properNoun
Stamov	Stamov	properNoun
Daloglu	Daloglu	properNoun
Clirim	Clirim	properNoun
Ansaldobreda	Ansaldobreda	properNoun
Koh	Koh	properNoun
Filipovska	Filipovska	properNoun
Kapshtica	Kapshtica	properNoun
Bunusevac	Bunusevac	properNoun
Badescu	Badecu	properNoun
Zasada	Zasada	properNoun
Gulova	Gulova	properNoun
Simion	Simion	properNoun
Vecdi	Vecdi	properNoun
Osmanovski	Osmanovski	properNoun
Potevska	Potevska	properNoun
Berkstock	Berkstock	properNoun
Mihordin	Mihordin	properNoun
Solnes	Solnes	properNoun
Kassianides	Kassianides	properNoun
Lidington	Lidington	properNoun
Boccolini	Boccolini	properNoun
Otterson	Otterson	properNoun
Snorrason	Snorrason	properNoun
Tandir	Tandir	properNoun
Vindija	Vindija	properNoun
Rosenborg	Rosenborg	properNoun
Elmir	Elmir	properNoun
Cosmofon	Cosmofon	properNoun
Shkëndije	Shkëndije	properNoun
Diamandouros	Diamandouros	properNoun
Lozen	Love	properNoun
Asparuhov	Asparuhov	properNoun
Filjak	Filjak	properNoun
Suhoi	Suhoi	properNoun
Ciglane	Ciglane	properNoun
Merdani	Merdani	properNoun
Gurgenidze	Gargenidze	properNoun
Shijaku	Shijaku	properNoun
Vozdovac	Vozdovac	properNoun
Ralitsa	Ralitsa	properNoun
Markale	Markale	properNoun
Qusay	Qusay	properNoun
Peternek	Peternek	properNoun
Rudan	Rudan	properNoun
Hammerberg	Hamérable	properNoun
Dida	Dida	properNoun
Murtezi	Murtezi	properNoun
Knezicek	Knezicek	properNoun
Ster	Ster	properNoun
Karagoz	Karagoz	properNoun
Siim	SIIM	properNoun
VipNet	Vipnet	properNoun
Zellweger	Zellweger	properNoun
Glynos	Glynos	properNoun
Hoshyar	Hoshyar	properNoun
Krall	Krall	properNoun
Ansip	Ansile	properNoun
Mica	le mica	noun
Mica	Mica	None
Hrvoje	Hrvoje	properNoun
Perperikon	Perperikon	properNoun
Famos	Fameux	properNoun
Bejta	Bejta	properNoun
Malic	Malicieux	properNoun
Georgeta	Georgeta	properNoun
Irbec	IRBEC	properNoun
Stipetis	Stipetis	properNoun
Emeklilik	Emeklilik	properNoun
Mpodosakis	Mpodosakis	properNoun
Shalqam	Shalqam	properNoun
Babamovski	Babamovski	properNoun
Zivko	Zivko	properNoun
Peterle	Banquet	properNoun
Hashimi	Hashimi	properNoun
Eldorado	Eldorado	properNoun
Ferrostaal	Ferrostail	properNoun
Brglevski	Brancard	properNoun
Zeri	Zeri	properNoun
Vukojicic	Vuskojicic	properNoun
Korydallos	Korydallos	properNoun
Arapoglou	Arapoglou	properNoun
Hedi	Hedi	properNoun
Avramovska	Avramovska	properNoun
Greussing	Créssant	properNoun
Meico	Meico	properNoun
Aquilotto	Aquilotto	properNoun
Tsvetanov	Tsvetanov	properNoun
Stefanoski	Stefanoski	properNoun
Burcica	Burcica	properNoun
Gonensin	Gonensin	properNoun
Zholdak	Zholdak	properNoun
Dajana	Dajana	properNoun
Todorovska	Todorovska	properNoun
Priscu	Prisci	properNoun
Nenad	Nenad	properNoun
Oslomej	Oslomej	properNoun
Branislava	Branislava	properNoun
Zvoncica	Zvoncica	properNoun
Guehenno	Guehenno	properNoun
Bejko	Bejko	properNoun
Dhurata	Dhurata	properNoun
Ilco	ILco	properNoun
Geta	Obtenir un	properNoun
Nemsic	Nemnique	properNoun
Urgup	Urgup	properNoun
Sarcevic	Sarcevic	properNoun
Baladeur	Baladeur	properNoun
Milojcic	Milojcic	properNoun
Porteils	Portiers	properNoun
Trikoukis	Trikoukis	properNoun
Scajola	Scajola	properNoun
Bilgehan	Bilgehan	properNoun
Plessas	Plessas	properNoun
Nae	Nae	properNoun
Makhdoom	Makhadoom	properNoun
Kiri	Kiri	properNoun
Tzanis	Tzanis	properNoun
Devolli	Devolli	properNoun
Brikel	Brikel	properNoun
Hoon	Haçon	properNoun
Romtelecom	Romtelecom	properNoun
Rasvan	Rasvan	properNoun
Cobra	le cobra	noun
Cobra	Cobra	None
Kiviniemi	Kiviniemi	properNoun
Nisantasi	Nisantasi	properNoun
Aggeliki	Aggeliki	properNoun
Merich	Merich	properNoun
Calmy	Calme	properNoun
Vnesheconombank	VnesheconomBank	properNoun
Harizaj	Harizaj	properNoun
Kllokoti	Kllokoti	properNoun
Lifipi	Lifipi	properNoun
Prizren	Prizren	properNoun
Sabla	Sabla	properNoun
Petko	Péko	properNoun
Ruma	Rumain	properNoun
Milva	Milva	properNoun
Horatiu	Horatiu	properNoun
KariZma	Karizma	properNoun
Ziegenfuss	Ziegenfuss	properNoun
Ruijten	Ruijten	properNoun
Withers	le garrot du cheval	noun
Withers	Flétrir	None
Tomica	Tomica	properNoun
Makaza	Makaza	properNoun
Ozbudun	Ozbudun	properNoun
Mihail	Mika	properNoun
Christoff	Christoff	properNoun
Moldpres	Moulage	properNoun
Lias	le liais	noun
Lias	Lias	None
Qazimi	Qazimi	properNoun
Cumhuriyet	Cumhuriyet	properNoun
Levitte	Lévitte	properNoun
Eurohold	Eurohold	properNoun
Rrapo	Rrapo	properNoun
Bodrozic	Bodrozique	properNoun
Shasivari	Shasivari	properNoun
Vergina	Vergina	properNoun
empathise	empathie	properNoun
Armo	Armoire	properNoun
Podeswa	Podeswa	properNoun
Rashidov	Rashidov	properNoun
Taksirat	Taksirat	properNoun
Beslija	Beslija	properNoun
Boogaloo	Boogaloo	properNoun
Raportaru	Raportaru	properNoun
Dimova	Dimova	properNoun
Dremelj	Dremelelj	properNoun
Enverism	Enverisme	properNoun
Bago	Bago	properNoun
Zlokas	Zlokas	properNoun
Kapija	Kapija	properNoun
Mlavi	Mlavi	properNoun
Onofri	Onofri	properNoun
Zubcevic	Zubcevic	properNoun
Saliu	Saliu	properNoun
Zivanic	Zivanique	properNoun
Yapici	Yapici	properNoun
Dado	la plinthe	noun
Dado	le lambris d'appui	noun
Dado	Dado	None
Petre	Petre	properNoun
Ozaydin	Ozaydin	properNoun
Fehir	Fehir	properNoun
Atun	Atun	properNoun
Ghanemm	Ghanemm	properNoun
Armand	Armand	properNoun
Battenberg	Battenberg	properNoun
Tod	Tod	properNoun
Uljrarevic	Uljrarevic	properNoun
Petkovska	Petkovska	properNoun
Adisa	Adisa	properNoun
Igov	Igov	properNoun
Surgutneftegaz	Surgutneftegaz	properNoun
Mafalani	Mafalani	properNoun
Arezzo	Arezzo	properNoun
Ergo	Ergo	properNoun
Kacan	Kacan	properNoun
Shoshi	Shoshi	properNoun
Naimova	Naimova	properNoun
Tatneft	Tataneft	properNoun
Gerxhaliu	Gerxhaliu	properNoun
Mitteleuropa	Mitteleuropa	properNoun
Invictus	Invictus	properNoun
Anmari	Anmari	properNoun
Lozanovski	Lozanovski	properNoun
Ivanjica	Ivanjica	properNoun
Akyurek	Akyurek	properNoun
Harald	Harald	properNoun
Despodov	Spoodov	properNoun
Mlloja	Mlloja	properNoun
Liz	Liz	properNoun
Regnum	Regnum	properNoun
Navracsics	Navracsics	properNoun
Qaeda	Qaïda	properNoun
Proeski	Proeski	properNoun
Klik	Klik	properNoun
Alogoskoufis	Alogoskoufis	properNoun
Brisevo	Brisevo	properNoun
two-year	deux ans	properNoun
Vlissingen	Vlissingen	properNoun
Tano	Tano	properNoun
Nezuk	Nezuk	properNoun
Tatlises	Tatlises	properNoun
Radomirovic	Radomirovic	properNoun
Nestos	Nestos	properNoun
Dymis	Dymis	properNoun
Silmak	Silamak	properNoun
Zilisteanu	Zilisteanu	properNoun
Elez	Elez	properNoun
Bojarov	Bojarov	properNoun
Ehud	Ehud	properNoun
Flen	Flener	properNoun
Vachev	Vachev	properNoun
Lakhonin	Lakhonine	properNoun
Neculae	Neculae	properNoun
Vinci	Vinci	properNoun
Kraljevi	Kraljevi	properNoun
Alicka	Alicka	properNoun
Panair	Panairier	properNoun
Latino	Latino	properNoun
Marlboro	Marlboro	properNoun
Zamfirescu	Zamfirecu	properNoun
Dushku	Dushku	properNoun
Rettenmaier	Retendmaier	properNoun
Monte Carlo	monte Carlo	properNoun
Greva	Greva	properNoun
Karalis	Karalis	properNoun
Lemierre	Lemierre	properNoun
Boutaris	Boutaris	properNoun
Shpiragu	Shppiragu	properNoun
Nihan	Nihan	properNoun
Prud	Prudic	properNoun
Berrer	Mieux	properNoun
Miljenko	Miljenko	properNoun
Erbay	Erbay	properNoun
N	N	properNoun
Morelenbaum	Morelenbaum	properNoun
Zeljana	Zeljana	properNoun
Bieber	Bieber	properNoun
Caka	Caka	properNoun
Poulsen	Poulsen	properNoun
Garganans	Garganans	properNoun
Varos	Varocs	properNoun
Canan	Canan	properNoun
Dritero	Dritero	properNoun
Suezmax	Suezmax	properNoun
Guus	Guus	properNoun
Derala	DERALA	properNoun
mp	député	properNoun
Lotsari	Lotari	properNoun
Daiichi	Daiichi	properNoun
Gunaydin	Gunaydin	properNoun
Aso	Aso	properNoun
Mallios	Mallios	properNoun
Gurgaj	Gurgaj	properNoun
Vranovac	Vranovac	properNoun
Enron	Enron	properNoun
Zeleznica	Zeleznica	properNoun
Lastavica	Lastavica	properNoun
Lama	le lama	noun
Lama	Lama	None
Gradiska	Gradiska	properNoun
Korhan	Korhan	properNoun
Valcheva	Valcheva	properNoun
Chol	Chol	properNoun
Kunarac	Kunarac	properNoun
Eremia	Eremia	properNoun
Kappa	la kappa	noun
Kappa	Kappa	None
Thabo	Thabo	properNoun
Aluminij	Aluminij	properNoun
Fadila	Fadila	properNoun
Krusteva	Krusteva	properNoun
Papandropoulos	Papandropoulos	properNoun
Martinon	Martinon	properNoun
Mercer	le marchand de tissu	noun
Mercer	Mercer	None
Bej	Bej	properNoun
Militaris	Militaris	properNoun
Hrustic	Hrustic	properNoun
Cavada	Cavada	properNoun
Kiko	Kiko	properNoun
Ogalar	Ogalar	properNoun
Katanec	Katanec	properNoun
Ovce	Ovce	properNoun
Ribayrol	Ribayrol	properNoun
Lichev	Lichev	properNoun
Patria	Patria	properNoun
Chernev	Chenev	properNoun
Banja Luka	Banja luka	properNoun
Modu	Modou	properNoun
Kukoc	Kukoc	properNoun
Tasev	Tasev	properNoun
Matsuura	Matsuura	properNoun
Emerton	Émerton	properNoun
Vettas	Vettas	properNoun
Volos	Volos	properNoun
Blagdan	Blagdan	properNoun
Enis	Enseigne	properNoun
Stankova	Stankova	properNoun
Antonelli	Antonelli	properNoun
Stefanis	Stefanis	properNoun
Zikica	Zikica	properNoun
Imbros	Imbros	properNoun
Stolac	Stolac	properNoun
Schenkel	Schenkel	properNoun
Petnica	Pétanique	properNoun
Dukagjin	Dukagjin	properNoun
Malatya	Malatya	properNoun
Midhat	Midhat	properNoun
Moloto	Moloto	properNoun
Mitroi	Mitroi	properNoun
Radiocom	Radiocom	properNoun
Pajtim	Pyjtim	properNoun
Valerian	la valériane	noun
Valerian	Valériane	None
Etemi	Eemi	properNoun
Guia	Guie	properNoun
Houssami	HOUSSAMI	properNoun
Rajko	Rajko	properNoun
Cenic	Cenique	properNoun
Bachvarova	Bachvarova	properNoun
Boro	Boro	properNoun
Mehter	Méchant	properNoun
Grunnet	Grunt	properNoun
Sadet	Sadet	properNoun
Genclerbirligi	GenclerBirligi	properNoun
Moghan	Moghan	properNoun
Tokuda	Tokuda	properNoun
Vukoti	Vukoti	properNoun
Vlachs	Vlachs	properNoun
Handziski	Handziski	properNoun
Rudez	Rude	properNoun
Vasnetsov	Vasnetsov	properNoun
Parivodic	Parivodique	properNoun
Bizanti	Bizanti	properNoun
Iskender	Iskender	properNoun
Kapikule	Kapikule	properNoun
Soltan	Soltan	properNoun
Dugolli	Dugolli	properNoun
Castel	Castel	properNoun
Kreditno	Kreditno	properNoun
Copos	Copos	properNoun
Resid	Résider	properNoun
Collegium	Collégium	properNoun
Espero	Espero	properNoun
Capan	Capan	properNoun
Hilversum	Hilversum	properNoun
Elektroprenos	Elektroprénos	properNoun
Kubicek	Kubicek	properNoun
Pec	Pec	properNoun
Duboko	Duboko	properNoun
Aravane	Arhavane	properNoun
Ethet	Éthique	properNoun
Gruppo	Gruppo	properNoun
Ukaj	Ukaj	properNoun
Strati	le stratus	noun
Strati	Strati	None
Akihiro	Akihiro	properNoun
Krelani	Krelani	properNoun
Souzhou	Suzhou	properNoun
Gambari	Gambari	properNoun
Pechalt	Pechalt	properNoun
Beriša	Beriša	properNoun
Makraduli	Makraduli	properNoun
party-internal	Party-interne	properNoun
Karasevo	Karasevo	properNoun
Lambrou	Lambrou	properNoun
Pasiardis	Pasiardis	properNoun
Aero	Aero	properNoun
Dafni	Dafni	properNoun
Namani	Namani	properNoun
Limnos	Limnos	properNoun
Miziri	Miziri	properNoun
Ereniku	Ereniku	properNoun
Slavik	Slavik	properNoun
Maimuni	Maïmuni	properNoun
Germanies	Germanies	properNoun
Firat	Firme	properNoun
Schilling	Schilling	properNoun
Tuovinen	Tuovinen	properNoun
Nussbaum	Nussbaum	properNoun
Harghita	Harghaita	properNoun
Andriake	Andriake	properNoun
Gergenlioglu	Gergenlioglu	properNoun
Risimkin	Risimkin	properNoun
Radwanska	Radwanska	properNoun
Peshkopi	Peshkopi	properNoun
Bensayah	Bensayah	properNoun
Ertugrul	Ertugrul	properNoun
Veljanoski	Veljanoski	properNoun
lie:1	Lie: 1	properNoun
Pevqeli	Pevqeli	properNoun
Nafplion	Nafplion	properNoun
Makedonka	Makedonka	properNoun
Porgy	Porcin	properNoun
Cukarica	Cukarica	properNoun
Dieter	Diététin	properNoun
Avacom	Avalité	properNoun
Jouyet	Jouyet	properNoun
Tanase	Tanase	properNoun
Vitinka	Vitinka	properNoun
Viadukt	Viadukt	properNoun
Bicakci	Bicakci	properNoun
Treviso	Trevise	properNoun
Christiaan	Christiaan	properNoun
Sariibrahimoglu	Saribriahimoglu	properNoun
Oba	Oba	properNoun
Humar	Humaire	properNoun
Nazarbaev	Nazarbayev	properNoun
Andjelka	Andjelka	properNoun
Brundtland	Brundtland	properNoun
Soelberg	Soelberg	properNoun
Aysun	Aysun	properNoun
Serban	Serban	properNoun
Kaljurand	Kaljurand	properNoun
Uras	Uras	properNoun
Eregli	Eregli	properNoun
Mandinga	Mandinga	properNoun
Karatancheva	Karachecheva	properNoun
Psarouda	Psarouda	properNoun
Tsoni	Tsoni	properNoun
Emporiki	Emporiki	properNoun
Soko	Soko	properNoun
Dobovac	Dobovac	properNoun
Durmus	Durmus	properNoun
Vernik	Vernik	properNoun
Baboianu	Baboianu	properNoun
Rebraca	Rebraca	properNoun
Gornja	Gornja	properNoun
Happel	Bonheur	properNoun
Javnosti	Javnosti	properNoun
Cvetjan	Cvetjan	properNoun
Egmont	Egmont	properNoun
Kunchev	Kunchev	properNoun
Aexonides	Aexonides	properNoun
finish looking	finir à la recherche de	properNoun
Noaghea	Noaghea	properNoun
Panagopoulos	Panagopoulos	properNoun
Galassi	Galasci	properNoun
Kozuf	Kozuf	properNoun
Erla	Erla	properNoun
Behring	Breveté	properNoun
Savka	Savka	properNoun
Somboled	Shampobé	properNoun
Althouse	Alternance	properNoun
Codruta	CODRUTA	properNoun
Zenica	Zenica	properNoun
Rogovanic	Rogovanique	properNoun
Threadgill	Fléau	properNoun
Stefanesti	Stefanesti	properNoun
Arakon	Arakon	properNoun
Werder	Werder	properNoun
self-finance	autofinancement	properNoun
Sead	Séduire	properNoun
Theocharous	Théoconque	properNoun
Tounousides	Telousides	properNoun
Utoeya	Utoeya	properNoun
Sinjavina	Sinjavina	properNoun
Kasipovic	Kasipovic	properNoun
Bratunac	Bratunac	properNoun
Krusevac	Krusevac	properNoun
Wirom	Fil	properNoun
Bozdo	Bozdo	properNoun
Merwin	Merwin	properNoun
Ayen	Ayen	properNoun
Locic	Local	properNoun
Kartalis	Kartalis	properNoun
Paravantes	Paravantes	properNoun
Basburg	Basbourg	properNoun
Ranan	Ranan	properNoun
Palade	Palais	properNoun
Shaul	SHAUL	properNoun
Sisedzam	Sëdzam	properNoun
Neskovic	Neskovic	properNoun
Polog	Polog	properNoun
Gunyuzu	Gunyuzu	properNoun
Stanterg	Stanterg	properNoun
Turkmen	Turkmène	properNoun
Artaida	Artisaya	properNoun
Herschbach	Herschbach	properNoun
Kukeri	Kukeri	properNoun
Soter	Sotteur	properNoun
Bogoljub	Bogoljub	properNoun
Mustafi	Mustafi	properNoun
Noppawan	Noppawan	properNoun
Enid	Énorme	properNoun
Sanda	Sanda	properNoun
Ravnik	Ravnik	properNoun
Ersoz	Ersoz	properNoun
Bollano	Bollano	properNoun
Milco	Milco	properNoun
Azeta	Azeta	properNoun
Vanik	Vanik	properNoun
Zeyid	Zeyid	properNoun
Refresh	rafraîchir	verb
Refresh	délasser	verb
Refresh	reposer	verb
Refresh	revigorer	verb
Refresh	se délasser	verb
Refresh	se détendre	verb
Refresh	se sentir revigoré	verb
Refresh	Rafraîchir	None
Sobotka	Sobotka	properNoun
Handizka	Hidizka	properNoun
Politiko	Politiko	properNoun
Azevski	Azevski	properNoun
Velichkov	Velichkov	properNoun
Majidi	Majidi	properNoun
Varnava	Varnava	properNoun
Uzice	Uzice	properNoun
Dmicic	Dmicic	properNoun
Zupanja	Zupanja	properNoun
Risto	Riston	properNoun
Radobolja	Radobolja	properNoun
Halilagic	Halilagique	properNoun
Obraz	Obraz	properNoun
Artana	Artana	properNoun
Orlen	Orlen	properNoun
Tomasz	Tomasz	properNoun
Pajico	Pajico	properNoun
Grashtica	Grashtica	properNoun
Prohic	Prohique	properNoun
Dilek	Dilek	properNoun
Duvankomerc	Duvankomerc	properNoun
Albahari	Albahari	properNoun
Erkanal	Erkanal	properNoun
Terinte	Terinte	properNoun
Geybulla	Geybulla	properNoun
Cana	Cana	properNoun
Servkom	Servonnue	properNoun
Svetoslav	Svetoslav	properNoun
Risvani	Risvani	properNoun
Alexandru	Alexandru	properNoun
Nizdara	Nizdara	properNoun
Stratis	Stratis	properNoun
Denovi	Denovi	properNoun
Pangalos	Pangalos	properNoun
Medzitlija	Medzitlija	properNoun
Vahe	Vahe	properNoun
Bujanovacka	Bujanovacka	properNoun
Rouy	Rouy	properNoun
Bercek	Bercek	properNoun
Ndoka	Ndoka	properNoun
Conta	Conta	properNoun
Michielsen	Michielsen	properNoun
Dokufest	Dokufest	properNoun
Eruh	Eruh	properNoun
Kraljevo	Kraljevo	properNoun
Epoque	Époque	properNoun
Vazir	Vomir	properNoun
Salata	Salata	properNoun
Bozin	Bozin	properNoun
reqiure	exiger	verb
reqiure	nécessiter	verb
reqiure	demander	verb
reqiure	requérir	verb
reqiure	avoir besoin	verb
reqiure	réclamer	verb
reqiure	vouloir	verb
reqiure	exiger	None
Xenides	Xénides	properNoun
Suvenir	Se suvenir	properNoun
Kasit	Kasut	properNoun
Bookfest	Bookfest	properNoun
Armutlieva	Armutlieva	properNoun
Koruturk	Koruturk	properNoun
Lubomir	Lubrifiant	properNoun
Samiu	Samiu	properNoun
Symantec	Symantec	properNoun
Petrobras	Petrobras	properNoun
Fetah	Fétah	properNoun
Everts	éventrer	verb
Everts	abattre	verb
Everts	dire tout	verb
Everts	Enthousiasme	None
Ardi	Ardi	properNoun
Tome	le tome	noun
Tome	les gros volume	noun
Tome	tome	None
Bokshi	Bokshi	properNoun
Gazette	la gazette	noun
Gazette	le journal officiel	noun
Gazette	l' annonce	noun
Gazette	publier	verb
Gazette	annoncer	verb
Gazette	Gazette	None
Pontassuglia	Pentasuglia	properNoun
Kokkalis	Kokkalis	properNoun
Limaj	Limaj	properNoun
Ernests	Arnest	properNoun
Tasiopoulos	Tasiopoulos	properNoun
Vervesos	Verve	properNoun
Animafest	Animé	properNoun
Cinbas	Cinbas	properNoun
Rexha	Rexha	properNoun
Cenak	Cenak	properNoun
Belchev	Belchev	properNoun
Ozak	Ozak	properNoun
Hajdinaga	Hajdinaga	properNoun
Smokvice	Fumée	properNoun
Futao	Futa	properNoun
Bogoridi	Bogourdi	properNoun
Bahri	Bahri	properNoun
Bilye	Bilye	properNoun
Brčko	Brčko	properNoun
Costis	Costis	properNoun
Medzit	Mec	properNoun
Popoviciu	Popoviciu	properNoun
Sava	Sava	properNoun
Politze	Poli	properNoun
Ucar	Ucar	properNoun
Boyanka	Boyau	properNoun
Cimber	Cimber	properNoun
Konuzin	Konuzin	properNoun
Ahmedi	Ahmedi	properNoun
Bierhoff	Bierhoff	properNoun
Nihat	Niitain	properNoun
Mitrovska	Mitrovska	properNoun
Erzincan	Erzincan	properNoun
Basak	Basak	properNoun
Paralympics	Paralympiques	properNoun
Hepi	Hépi	properNoun
Interina	Internaune	properNoun
Soren	Soren	properNoun
Hatidza	Hatidza	properNoun
Rrezhen	Rrezhen	properNoun
Broadman	Largeur	properNoun
Priester	Précieux	properNoun
Ute	Ute	properNoun
Skouris	Skouris	properNoun
Bayerl	Bayerl	properNoun
Albita	Allégué	properNoun
Upiana	Upiana	properNoun
Daors	Ordonnance	properNoun
Kanatlarovski	Kanatlarovski	properNoun
Zilkic	Zilkic	properNoun
Dakovo	Dakovo	properNoun
Tekbilek	Tekbilek	properNoun
Diepen	Diepen	properNoun
Bednarek	Bednarek	properNoun
Hyatt	Hyatt	properNoun
Paljetak	Palpetak	properNoun
Holstein	Holstein	properNoun
Blido	Blido	properNoun
Megalopoli	la mégalopole	noun
Megalopoli	Mégalopoli	None
Pandeleimonos	Pandeleimonos	properNoun
Bezanijska	Bezanijska	properNoun
Kermabon	Kermabon	properNoun
Gourley	Gourmand	properNoun
Nogaideli	Nogaideli	properNoun
Bigovic	Bigovic	properNoun
Hancesti	Hancesti	properNoun
Iqaluit	Iqaluit	properNoun
Aphis	Aphis	properNoun
Saranda	Saranda	properNoun
Trajal	Trajal	properNoun
Orbis	Orbis	properNoun
Kolakovic	Kolakovic	properNoun
Radenovic	Radenovic	properNoun
Peskiric	Peskiric	properNoun
Prohaska	Prohaska	properNoun
Bahtir	Bahtir	properNoun
Roxy	Roxy	properNoun
Kocev	Kocev	properNoun
Srem	Srem	properNoun
Kerem	Kerem	properNoun
Kozloduy	Kozloduy	properNoun
Dedalos	Délégué	properNoun
Zokora	Zokora	properNoun
Ramsar	Ramsar	properNoun
Andja	Etja	properNoun
Santer	Santer	properNoun
Kostres	Kostres	properNoun
Saeed	Souillé	properNoun
Marlena	Marlena	properNoun
Antolos	Antolos	properNoun
Willem	Willem	properNoun
Solberg	Solberg	properNoun
Livade	Priver	properNoun
Archondoula	Archondoula	properNoun
Tatar	tatar	adjective
Tatar	le tatar	noun
Tatar	le Tatar	noun
Tatar	Tatar	None
Bojcevski	Bojcevski	properNoun
Miltiadis	Miltiadis	properNoun
Krnojelac	Krnojelac	properNoun
Bost	Boster	properNoun
Doppelmayer	Doppelmayr	properNoun
Kythira	Kythira	properNoun
Ulez	Ulez	properNoun
Goli	Goli	properNoun
Presa	Presa	properNoun
Haliasso	Haliasso	properNoun
Merz	Merz	properNoun
Rafet	Raft	properNoun
Demarty	Démarreur	properNoun
Krk	Krk	properNoun
Shirin	Shirin	properNoun
Lepic	Léger	properNoun
Fife	le fifre	noun
Fife	Fifre	None
Raca	Raca	properNoun
Stelian	Stelian	properNoun
Dilas	Dilas	properNoun
Wiberg	Chapelet	properNoun
Ninepin	Neuf	properNoun
Pirsic	Pirsique	properNoun
Dobrich	Dobrich	properNoun
Panagiota	Panagiota	properNoun
Mackic	Mackic	properNoun
Dragoslav	Dragoslav	properNoun
Davorin	Davorine	properNoun
Mente	Menthe	properNoun
Cavkic	Cavgique	properNoun
Musabegovic	Musabegovic	properNoun
Sofuoglu	Canofuoglu	properNoun
Eshetu	Esheutu	properNoun
Gribenco	Gribenco	properNoun
Keskin	Keskin	properNoun
Vokshi	Vokshi	properNoun
Militiades	Miltiades	properNoun
Transworld	Transworld	properNoun
Kiro	Kiro	properNoun
Cvetanka	Cvetanka	properNoun
Enache	S'écarter	properNoun
Vyron	Vyron	properNoun
Kerchove	Kerchove	properNoun
Hristovska	Hristovska	properNoun
Begator	Agresseur	properNoun
Cakir	Cakir	properNoun
Pogorelic	Pogorélique	properNoun
Gregorios	Grégorios	properNoun
Toska	Toska	properNoun
Vural	Vitrave	properNoun
Saper	Sperme	properNoun
Abrum	Abrupt	properNoun
Smilodon	Smilodon	properNoun
Palic	Paume	properNoun
Cervar	Cervar	properNoun
Wolfowitz	Wolfowitz	properNoun
Kalbinur	Kalbinur	properNoun
Entergy	Entourant	properNoun
Grahovcici	Grahovcici	properNoun
Eviva	Eviva	properNoun
Dobran	Dobran	properNoun
Komedija	Komedija	properNoun
Storaro	Storaro	properNoun
Silman	Silhour	properNoun
Shuperka	Shuperka	properNoun
Ecka	Ecka	properNoun
Trnovo	Trnovo	properNoun
Altavilla	Altavilla	properNoun
Kosumi	Kosumi	properNoun
Bekteshi	Bekteshi	properNoun
Bode	présager	verb
Bode	augurer	verb
Bode	Présager	None
Salzmann	Salzmann	properNoun
Surbanovski	Surbanovski	properNoun
Kazanluk	Kazanluk	properNoun
do sport	faire du sport	properNoun
MosNews	Mosnews	properNoun
Sparkes	Étincelles	properNoun
Cialdini	Cialdini	properNoun
Stegnite	Stegnite	properNoun
Quadras	Quadra	properNoun
Electrocentrale	Électrocentrale	properNoun
Cosmotelco	Cosmotelco	properNoun
Zeul	Zeul	properNoun
Koehler	Koehler	properNoun
Aniko	Aniko	properNoun
Kioko	Kioko	properNoun
Bemal	Bémol	properNoun
Lalzi	Lalzi	properNoun
Doncho	Doncho	properNoun
Netinfo	Netinfo	properNoun
Epivates	Épargner	properNoun
Plevneliev	Plévneliev	properNoun
Grigor	Grève	properNoun
Herzberger	Herzberger	properNoun
Malisheva	Malisheva	properNoun
Caushi	Caushi	properNoun
Operalia	Opération	properNoun
Ibrahimi	Ibrahimi	properNoun
Hajdin	Hajdin	properNoun
Manolache	Manolache	properNoun
Scurtu	Scurtu	properNoun
Ercegovic	Ercegovic	properNoun
Eckart	Eckart	properNoun
Pascrell	Pascrarr	properNoun
Aristomenis	Aristoménis	properNoun
Dereta	Dereta	properNoun
Angelides	Angelides	properNoun
Maloku	Malheur	properNoun
Gjata	Gjata	properNoun
Sterjovski	Sterjovski	properNoun
Karlovitz	Karlovitz	properNoun
Bekes	Bekes	properNoun
Heydecker	Heydecker	properNoun
Valdrobrev	Valdrobrev	properNoun
Lancuzanin	Lancuzanin	properNoun
Ivelina	Ivard	properNoun
Palio	Palais	properNoun
Labunishta	Labunishta	properNoun
Suzana	Suzana	properNoun
Crosco	Crosco	properNoun
Dhrovjan	Dhrovjan	properNoun
Harri	Harri	properNoun
Rusmir	Rusmir	properNoun
Lokman	Lokman	properNoun
Elmazi	Elmazi	properNoun
Elisavet	Elisave	properNoun
Pag	PSG	properNoun
Kakanj	Kakanj	properNoun
Irogce	Irogce	properNoun
Fusu	Fusu	properNoun
Knjazevac	Knjazevac	properNoun
Desaret	Désagrét	properNoun
Barbarosie	Barbarosie	properNoun
Gennimata	Gennimata	properNoun
Barbutov	Barbutov	properNoun
Stanoev	Stantanev	properNoun
Gherasim	Gerser	properNoun
Plinacro	Plinacro	properNoun
Izeir	Izeir	properNoun
Nagip	Nagip	properNoun
Albpetrol	Albpetrol	properNoun
Nechirvan	Nechirvan	properNoun
Nikicevic	Nikicevic	properNoun
Lubonja	Lubonja	properNoun
Ekonomi	Ekonomi	properNoun
Shammas	Shammas	properNoun
Ognjen	Ognjen	properNoun
Stieg	Stieg	properNoun
Sozen	Sozen	properNoun
Patoulis	Patoulis	properNoun
Shkreli	Shkreli	properNoun
Petak	Pétak	properNoun
Ipres	Ipres	properNoun
Chikako	Chikako	properNoun
Zagorec	Zagorec	properNoun
Isaja	Isaja	properNoun
Manjaca	Manjaca	properNoun
Kodro	Kodro	properNoun
Barmak	Barba	properNoun
Lakhdar	Lakhdar	properNoun
Petranovic	Pétranovic	properNoun
Monastiraki	Monastiraki	properNoun
Bentegeat	Bentene	properNoun
Senjski	Senjski	properNoun
Durguti	Durguti	properNoun
Anonimul	Anonimul	properNoun
Lovech	Lovech	properNoun
Mashrouh	Mashrouh	properNoun
Bostjan	Bostjan	properNoun
Totti	Totti	properNoun
Achkovska	Achkovska	properNoun
Shehu	Shehu	properNoun
Beral	Beral	properNoun
Nesirky	Néné	properNoun
Solakov	Solakov	properNoun
Magoula	Magoulé	properNoun
Spanja	Spanja	properNoun
Karoly	Karolie	properNoun
Ulpiana	Ulpiana	properNoun
Arnand	Arnand	properNoun
Gavrilovski	Gavrilovski	properNoun
Kukesi	Kukesi	properNoun
Turbo	Turbo	properNoun
Majid	Majide	properNoun
Vitomir	Viomir	properNoun
Polenak	Polénak	properNoun
Iivonen	Iivonen	properNoun
Stefanovic	Stefanovic	properNoun
Au	Autant	properNoun
Krupiste	Krupiste	properNoun
Metskhvarishvili	Metskhvarishvili	properNoun
Klasik	Klasik	properNoun
Kurtaliqi	Kurtaliqi	properNoun
Osamas	Osamas	properNoun
Beyazid	Bayezid	properNoun
Plaza	la place	noun
Plaza	le centre commercial	noun
Plaza	le péage	noun
Plaza	l' aire de stationnement	noun
Plaza	Place	None
Zajc	Zajc	properNoun
Katica	Katic	properNoun
Schloter	Schloter	properNoun
Mogila	Mogila	properNoun
Shehri	Shehri	properNoun
Albena	Albène	properNoun
Milaku	Milaku	properNoun
Romela	Romela	properNoun
Lacrimosa	Romela	properNoun
Trigonis	Trigonis	properNoun
Gokdemir	Gokdemir	properNoun
Kukic	Kukic	properNoun
Kabashi	Kabashi	properNoun
Svob	Svob	properNoun
Cortina	Cortina	properNoun
Kulevi	Kulevi	properNoun
Haci	Haci	properNoun
Soto	De manière à	properNoun
Kimet	Kimet	properNoun
Vachkov	Vachkov	properNoun
Grkic	Grançon	properNoun
Eurokompozit	Eurokompozit	properNoun
Shoushoulov	Shoushoulov	properNoun
Vinson	Vinson	properNoun
Slobodanka	Slobodanka	properNoun
Abduladi	Abduladi	properNoun
Vasilj	Vasilj	properNoun
Audronius	Audio	properNoun
MedOil	Medoil	properNoun
Uckuyular	Uckuyulaire	properNoun
Skiathitis	Skiacéthite	properNoun
Biclea	Biclea	properNoun
Mediu	Mediu	properNoun
Dimeski	Dimeski	properNoun
Faiella	Faiella	properNoun
Angelovski	Angelovski	properNoun
Lambridinis	Lambridinis	properNoun
Qalferat	QALFERAT	properNoun
Seb	Seb	properNoun
Villiers	Villiers	properNoun
Tubulcus	Tubulcus	properNoun
Granit	Granulée	properNoun
Admir	Admirant	properNoun
Balkanblogs	Balkanblogs	properNoun
Nevesinje	Nevênje	properNoun
Spase	Spase	properNoun
Copic	Copieux	properNoun
Catorososka	Catherososka	properNoun
Chae	Chae	properNoun
Vrettos	Vretos	properNoun
Gosposarska	Gosaparska	properNoun
Murati	Murati	properNoun
Lambridis	Lambridis	properNoun
Adametz	Adametz	properNoun
Onar	Onar	properNoun
Faye	Faye	properNoun
Sibal	Sibal	properNoun
Bejtush	Bejtush	properNoun
Myftiu	Myftiu	properNoun
spread about	se répandre à propos de	properNoun
Chisinau	Chisinau	properNoun
Stanisoara	Stanisoara	properNoun
Abdula	Abdula	properNoun
Tesanj	Tesanj	properNoun
Asim	Asim	properNoun
Mohsen	Mohsen	properNoun
Otranto	Otranto	properNoun
Zoellick	Zoellick	properNoun
Vitanov	Vitanov	properNoun
Dassin	Dassin	properNoun
Metronet	Métronét	properNoun
Brvenica	Bracieux	properNoun
Safina	Safina	properNoun
take more	prends en plus	properNoun
Schnack	Schnack	properNoun
Bayulgen	Bayulgen	properNoun
Mobiltel	Mobilel	properNoun
Milko	Lait	properNoun
Portillo	Portillon	properNoun
Ciolos	Ciolos	properNoun
Neoklis	Neoklis	properNoun
Urso	Urso	properNoun
Terzi	Terzi	properNoun
Rodan	Rodan	properNoun
Unal	Unal	properNoun
Cacic	Cacique	properNoun
Lauterstein	Lauterstein	properNoun
Alexandrou	Alexandrou	properNoun
Krcki	Krcki	properNoun
Rastko	Rastko	properNoun
Ingrao	Ingrao	properNoun
Kentel	Kentel	properNoun
Edibe	Édition	properNoun
Shin	le tibia	noun
Shin	le jarret de bœuf	noun
Shin	Tibia	None
Mykoniati	Mykoniati	properNoun
Vlahovljak	Vlahovljak	properNoun
Repnik	Repnik	properNoun
Boerse	Boerse	properNoun
Grattam	Grattan	properNoun
Nikolchovski	Nikolchovski	properNoun
Inan	Inan	properNoun
Courbin	Courbin	properNoun
Demetriou	Demetriou	properNoun
Riman	Ruman	properNoun
Staka	Staka	properNoun
Kuribak	Kuribak	properNoun
Vukasin	Vicassin	properNoun
Stina	Stina	properNoun
Herr	Hérins	properNoun
Ersun	Ersun	properNoun
Zineb	Zineb	properNoun
Mlikotin	Mlikotine	properNoun
Falcetti	Falcetti	properNoun
Okumus	Okumus	properNoun
Glafcos	Glafcos	properNoun
Okcular	Okculaire	properNoun
Mihalcea	Mihalcéa	properNoun
Kouassi	Kouassi	properNoun
Rataj	Rataj	properNoun
Prevalla	Prevala	properNoun
Avalon	Avalon	properNoun
Ricardinho	Avalon	properNoun
Kajtazi	Kajtazi	properNoun
Sokolova	Sokolova	properNoun
Meseberg	Meseberg	properNoun
Bayramoglu	Bayramoglu	properNoun
Magris	Magris	properNoun
Rugovism	Rugovisme	properNoun
Fofi	Fofi	properNoun
Kolja	Kolja	properNoun
Minelli	Mineur	properNoun
Petya	Petya	properNoun
Ashkali	Ashkali	properNoun
Cha	Chat	properNoun
Zhurnal	Zharnal	properNoun
Jelev	Jelev	properNoun
Groehe	Grohe	properNoun
Subashi	Subashi	properNoun
Banica	Banque	properNoun
Semiha	Semiha	properNoun
Sadem	Sadem	properNoun
UniCredit	Unicredit	properNoun
Heilman	Heeil	properNoun
Dabbagh	Dabbagh	properNoun
Haraszti	Haraszti	properNoun
Blazhi	Blazhi	properNoun
Mrzenci	Mrzenci	properNoun
Dimkovski	Dimkovski	properNoun
Dobruna	Dobruna	properNoun
Ethem	Éthématique	properNoun
Roibu	Roibu	properNoun
Oana	Oana	properNoun
Crescent	croissant	adjective
Crescent	le croissant	noun
Crescent	la route courbée	noun
Crescent	Croissant	None
Mihacic	Mihacique	properNoun
Malmstrom	Malmstrom	properNoun
Taseva	Taseva	properNoun
Panova	Panovie	properNoun
Ratel	le ratel	noun
Ratel	Ratel	None
Helogistics	Hélicoïde	properNoun
Binici	Binici	properNoun
Kampf	Kampf	properNoun
Vitosha	Vitosha	properNoun
Vezhdi	Vezhdi	properNoun
Repetitor	Répéteur	properNoun
Pajevic	Pyjevic	properNoun
Franken	Franc	properNoun
Bjelinski	Bjelinski	properNoun
Wilders	Sauvager	properNoun
Perwer	Perfectionner	properNoun
Bingol	Bingol	properNoun
Druze	Druze	properNoun
Sukarov	Sukarov	properNoun
Sioufas	Sioufas	properNoun
Tsiganos	Tsiganos	properNoun
Panki	Pandi	properNoun
Tsiganis	Tsiganis	properNoun
Pivofest	Pivofest	properNoun
Mosadian	Mosadian	properNoun
Zhelezarov	Zhelezarov	properNoun
Stancu	Stanci	properNoun
Tatikev	Tatikev	properNoun
Kopalnia	Kopalnie	properNoun
Klynge	Klynge	properNoun
Tagver	Tagon	properNoun
Uludag	Uludag	properNoun
Brijeg	Brijeg	properNoun
Pletikosa	Pletikosa	properNoun
Nikitas	Nikitas	properNoun
Mancur	Colorant	properNoun
Pocitos	Pocitos	properNoun
Bourousis	Bourousis	properNoun
Stoykova	Stoykova	properNoun
Konjukusic	Konjukusic	properNoun
Stolojan	Stolojan	properNoun
Kursat	Kursat	properNoun
Sedlar	Sedlar	properNoun
Feith	Creuser	properNoun
Amfilohije	Amfilohije	properNoun
Rachlin	Rachlin	properNoun
Alhala	Alhala	properNoun
Tkalcec	Tkalcec	properNoun
Plaks	Plaque	properNoun
Dargecit	Dargécit	properNoun
Taravi	Taravi	properNoun
Galiano	Galano	properNoun
Tusak	Tausak	properNoun
Liukin	Liukin	properNoun
Sokolenko	Sokolenko	properNoun
Tomaz	Tomaz	properNoun
Bolani	Bolani	properNoun
Mures	Mure	properNoun
Ulemek	Ulemek	properNoun
Hentov	Hentou	properNoun
Floridis	Floride	properNoun
Akerholm	Akerholm	properNoun
Bobic	Bobique	properNoun
Winkler	Winkler	properNoun
Tăriceanu	Tăriqueanu	properNoun
Kazaz	Kazaz	properNoun
Maslak	Maslak	properNoun
Arifagic	Arifagique	properNoun
Demitris	Demitris	properNoun
Muharemovic	Muharemovic	properNoun
Paar	Muharemovic	properNoun
Dovranic	Dovranic	properNoun
Gonçalo	Gonçalo	properNoun
Simsek	Simsek	properNoun
Troshani	Troshani	properNoun
Bezhani	Bezhani	properNoun
Mahmutoglu	Mahmutoglu	properNoun
Aleka	Aleka	properNoun
Sakarya	Sakarya	properNoun
Eskisehir	Eskisehir	properNoun
Patriciu	Patriciu	properNoun
Smiljana	Smiljana	properNoun
Svetozar	Svetozar	properNoun
Avci	Avci	properNoun
Nikinci	Nikinci	properNoun
Librescu	Librescu	properNoun
Golijan	Golijan	properNoun
Calinescu	Calinescu	properNoun
Tritan	Tritu	properNoun
Ozbay	Ozbay	properNoun
Harilaos	Harilaos	properNoun
Aydar	Aydar	properNoun
Zico	Zico	properNoun
Aktutun	Aktutun	properNoun
Tahsin	Tahsin	properNoun
Otlja	Otlja	properNoun
Blerta	Balle	properNoun
brighten up	égayer	verb
brighten up	rendre clair	verb
brighten up	faire apparaître	verb
brighten up	s'éclairer	verb
brighten up	éclaircir	None
Kell	Kell	properNoun
Papaioannou	Papaioannou	properNoun
Eurobest	Eurobest	properNoun
Dragus	Dragus	properNoun
Sovanj	Sovanj	properNoun
Sambo	Sambo	properNoun
Damgaci	Damgaci	properNoun
Ernestinovo	Ernestinovo	properNoun
Karaosmanoglu	Karosmanoglu	properNoun
Missy	Missy	properNoun
Hamam	Hamam	properNoun
Tolev	Tolev	properNoun
Kosgei	Kosgei	properNoun
Paet	Palet	properNoun
Actualno	Actualno	properNoun
Hamdiu	Hamdiu	properNoun
Hubner	Hubner	properNoun
Sumidero	Sumidero	properNoun
Kuckovo	Kuckovo	properNoun
Finnen	Final	properNoun
Zejna	Zejna	properNoun
Rusina	Rusina	properNoun
Grimason	Grimason	properNoun
Dvoranic	Dvoranique	properNoun
Eylul	Écouler	properNoun
Fotolia	Fotolia	properNoun
Sanliurfa	Sanliurfa	properNoun
Bardh	Bardh	properNoun
Stoychev	Stoychev	properNoun
Saarbruecker	Saarbruecker	properNoun
Damanaki	Damanaki	properNoun
Khatami	Khatami	properNoun
Kherimyan	Kherimyan	properNoun
Veliu	Veliu	properNoun
Posavina	Posavina	properNoun
Serono	Seron	properNoun
Natiq	NatiQ	properNoun
Treneska	Trèneska	properNoun
Tropik	Tropik	properNoun
Krassi	Krasi	properNoun
Adriatics	Adriatique	properNoun
Dokos	Dokos	properNoun
Miso	Miso	properNoun
Korodi	Korodi	properNoun
Adalet	Adalet	properNoun
Krasimir	Krasimir	properNoun
Ponos	Ponos	properNoun
Haselau	Haselau	properNoun
Geramitcioski	Geramitcioski	properNoun
Pimpsons	Pimpsons	properNoun
EuroMarket	Euromarket	properNoun
Mavra	Mavra	properNoun
Tzorvas	Tzorvas	properNoun
for the duration of	pendant la durée de	properNoun
Biocina	Biocine	properNoun
Merkulov	Merkulov	properNoun
Atmaca	Atmaca	properNoun
Unilever	Unilever	properNoun
Shatri	Shatri	properNoun
Marbo	Marbo	properNoun
Rrustemi	Rrustemi	properNoun
Stenmark	Share	properNoun
Coliseum	le Colisée	noun
Coliseum	Colisée	None
Mamedyarov	Mamedyarov	properNoun
Kontrol	Kontrol	properNoun
Ermonela	Ermonela	properNoun
Brezovica	Brezovica	properNoun
Belozem	Brezovica	properNoun
Konyali	Konyali	properNoun
Garmisch	Garmisch	properNoun
Vasilikos	Vasilikos	properNoun
work together	travailler ensemble	properNoun
Koli	Koli	properNoun
get into	entrer dans	verb
get into	aborder	verb
get into	monter	verb
get into	se lancer	verb
get into	loger	verb
get into	s'impliquer	verb
get into	entrer dans	None
Handl	Manœuvre	properNoun
Hannelore	Hannelore	properNoun
Shenglin	Shenglin	properNoun
Besmir	Shenglin	properNoun
Rudnik	Rudnik	properNoun
Olle	Olle	properNoun
Custura	Custoure	properNoun
Prso	Discussion	properNoun
Vahind	Discussion	properNoun
Utsumi	Utsumi	properNoun
Zelic	Zélique	properNoun
Belfrage	Belfrage	properNoun
Lindhagen	Lindhagen	properNoun
Makrevski	Makrevski	properNoun
Kosovareport	Kosovareport	properNoun
Ploiesti	Ploiesti	properNoun
Igman	Igman	properNoun
Troch	Troupes	properNoun
Kazantzakis	Kazantzakis	properNoun
Zentralbank	Zentralbank	properNoun
Dicker	marchander	verb
Dicker	Marchander	None
Alphons	Alphones	properNoun
Batu	Batu	properNoun
Vaptsarov	Vaptsarov	properNoun
Gavrilova	Gavrilova	properNoun
Lacin	Lacin	properNoun
Nizret	Nizreau	properNoun
Vasso	Vasso	properNoun
Penescu	Penescu	properNoun
Erenoglu	Erenoglu	properNoun
Verbundplan	Verbundplan	properNoun
Dolinar	Dolinar	properNoun
Panagidis	Panagidis	properNoun
Obrador	Obrador	properNoun
Hushi	Hushi	properNoun
Puhalac	Puhalac	properNoun
Bakalli	Bakalli	properNoun
Cocoli	Cocoli	properNoun
LindArt	Lindarte	properNoun
Kandilli	Kandilli	properNoun
Vermnice	Vermnice	properNoun
Nesovski	Nesovski	properNoun
Vilssingen	Vlissingen	properNoun
Neuschul	Neuschul	properNoun
Karabulut	Karabulut	properNoun
Islanders	l' habitants des îles	noun
Islanders	Insulaires	None
Corciu	Corciu	properNoun
Tailo	Tavie	properNoun
Provopoulos	ProvOmoulos	properNoun
Seref	Seref	properNoun
Marisavljevic	Marisavljevic	properNoun
Ambroso	Ambroso	properNoun
Dvor	Dvor	properNoun
Oltchim	Oltchim	properNoun
Areva	Areva	properNoun
Seselj	Seselj	properNoun
Coldea	Froid	properNoun
Fonići	Fonići	properNoun
Momo	Momo	properNoun
Vatnika	Vatnika	properNoun
Kongra	Kongra	properNoun
Lavoncourt	Lavoncourt	properNoun
Maximos	Maximos	properNoun
Ajit	Ajit	properNoun
Marika	Marika	properNoun
Kavaf	Kavaf	properNoun
Gallac	Gallac	properNoun
Karlovic	Karlovic	properNoun
Carsten	Carstène	properNoun
Cvejic	Cvejic	properNoun
Koprivnicki	Koprivnicki	properNoun
Souljazz	Souljazz	properNoun
deputyprimeminister	vice-Premier ministre	properNoun
Putko	Putko	properNoun
Krum	Krum	properNoun
Kerry	Kerry	properNoun
Protek	Protéger	properNoun
Klina	Klina	properNoun
Poljud	Poljud	properNoun
Uvalic	Uvalique	properNoun
Rejhan	Rejhan	properNoun
Thurow	Thurow	properNoun
Donka	Donka	properNoun
Prigozhin	Prigozhin	properNoun
Nedkov	Nedkov	properNoun
Vakifli	Vakifli	properNoun
Sfakia	Sfakia	properNoun
Simitis	Simitis	properNoun
Turkcell	Turkcell	properNoun
Uni	fac	abbreviation
Uni	collège	abbreviation
Uni	Uni	None
Adrianos	Adrianos	properNoun
Veljko	Veljko	properNoun
Braila	Braila	properNoun
Ergos	Ergos	properNoun
Stratan	Stratan	properNoun
Wolski	Wolski	properNoun
Dervo	Dervo	properNoun
Morillon	Morillon	properNoun
Agentur	Agent	properNoun
Klapsis	Klapsis	properNoun
Kahkonen	Kahkonen	properNoun
Almacian	Almacien	properNoun
Trohorov	Trhorov	properNoun
Nardin	Nardin	properNoun
Siccardi	Siccardi	properNoun
Ikon	l' icône	noun
Ikon	Icône	None
Ainouz	Ainouz	properNoun
Grujica	Grujica	properNoun
Rizo	Rizo	properNoun
Obucina	Obus	properNoun
Idool	Idiot	properNoun
Pantelis	Pantelis	properNoun
Zajovic	Zajovic	properNoun
Patil	Pattil	properNoun
Shkullaku	Shkullaku	properNoun
Nisici	Nisici	properNoun
Lajovic	Lajovic	properNoun
Gerasimos	Gerasimos	properNoun
Gama	Gama	properNoun
Opa	Opa	properNoun
Kwon	Kwon	properNoun
Banjalic	Banjalique	properNoun
Hildergart	Hildergart	properNoun
Farul	Faroule	properNoun
Epidauros	Épidaure	properNoun
Turturica	Turturica	properNoun
Steble	Diriger	properNoun
Shimomura	Shimomura	properNoun
Mladenov	Mladenov	properNoun
Palacky	Palais	properNoun
Edlira	Edlira	properNoun
Habibe	Habilité	properNoun
Katev	Katev	properNoun
Vernicos	Vernis	properNoun
Vashadze	Vatashane	properNoun
Petro	Petro	properNoun
Mladan	Mladan	properNoun
Katainen	Katainen	properNoun
Rumelia	Rumelie	properNoun
Visocica	Visocica	properNoun
Gundogdu	Gungdu	properNoun
Kreckovic	Kreckovic	properNoun
Miclea	Micllea	properNoun
Zaim	Zaim	properNoun
Beyrle	Beyrle	properNoun
Puwak	Puwak	properNoun
Shalgam	Shalgam	properNoun
Leonberger	Léonberger	properNoun
Laktasi	Laktasi	properNoun
Rripe	Rire	properNoun
Damyanov	Damyanov	properNoun
Ranka	Ranka	properNoun
Papademos	Papademos	properNoun
Biljani	Biljani	properNoun
Amartya	Amartya	properNoun
Mantelis	Mantelis	properNoun
Hasankeyf	Hasankeyf	properNoun
Arvaniti	Arvaniti	properNoun
Tokovic	Tokovic	properNoun
Alireza	Alieza	properNoun
for the purpose of	dans le but de	properNoun
Defrim	Défrim	properNoun
Ika	Ika	properNoun
Asena	Asena	properNoun
Baraner	Baraneuse	properNoun
Marotov	Marrotov	properNoun
Manohla	Manohla	properNoun
Lakitic	Lakiticique	properNoun
Fuele	Dele	properNoun
Larionda	Larionda	properNoun
Gotisan	Gotisan	properNoun
Tampakos	Tampakos	properNoun
Spundov	Spundov	properNoun
Ajkai	Ajkai	properNoun
Gunchev	Gossev	properNoun
Didem	Didem	properNoun
Takashi	Takashi	properNoun
Memeti	Memeti	properNoun
Flexi	Flexi	properNoun
Societe	Société	properNoun
Hurriyet	Hurriyet	properNoun
Franziska	Franziska	properNoun
Ardian	Ardian	properNoun
Mikhel	Mikhel	properNoun
Baze	Baisser	properNoun
Erdemir	Erdemir	properNoun
Demos	Démos	properNoun
Teona	Teona	properNoun
Anica	Anica	properNoun
Schafferer	Schfferer	properNoun
Euroroma	Euros	properNoun
Vangelovski	VANGELOVSKI	properNoun
Gracanica	Gracanica	properNoun
Budayci	Budayci	properNoun
Paleologu	Paléologu	properNoun
Nasev	Nasev	properNoun
Ciorbea	Ciorbea	properNoun
Kenderis	Kenderis	properNoun
Fassianos	Fastidianos	properNoun
Romexpo	Romexpo	properNoun
Matka	Matka	properNoun
Serb	serbe	adjective
Serb	le serbe	noun
Serb	Serbe	noun
Serb	serbe	None
Kollatz	Kollatz	properNoun
Paunkovic	Punkovic	properNoun
Zeljeznica	Zeljeznica	properNoun
Gargalionis	Gargalionniste	properNoun
Arbereshe	Arbereshe	properNoun
Mehmedovic	Mehmedovic	properNoun
Pybus	Pybus	properNoun
Sasko	Sasko	properNoun
Sarachini	Sarachini	properNoun
Flickenschild	Flickenschild	properNoun
Friedhof	Friedhof	properNoun
Vedran	Védran	properNoun
Zarko	Zarko	properNoun
Politis	Politique	properNoun
Himzo	Himzo	properNoun
Marmaris	Marmaris	properNoun
pick off	enlever	verb
pick off	abattre	verb
pick off	cueillir	verb
pick off	gratter	verb
pick off	enlever	None
Bulgaricum	Bulgaricum	properNoun
Cenev	Cyv	properNoun
Kajmakchalan	Kajmakchalan	properNoun
Suhadoll	Suhadoll	properNoun
Gergawi	Gergawi	properNoun
Goles	Golfe	properNoun
Lukavac	Lukavac	properNoun
Amato	Amato	properNoun
Umraniye	Umraniye	properNoun
Corovic	Corovic	properNoun
Fadil	Fadil	properNoun
Ferraj	Ferraj	properNoun
Krommenacker	Krommenacker	properNoun
Kudinov	Kudinov	properNoun
Glezos	Glezos	properNoun
Vitez	Vitez	properNoun
Hadjiemmanuel	Hadjiemmanuel	properNoun
Kasalica	Kasalique	properNoun
Ulcinjska	Ulcinjska	properNoun
Zurab	Zurab	properNoun
Tsitsipis	Tsitsipis	properNoun
Tulcea	Tulcea	properNoun
Sivas	Sivas	properNoun
Eleftheriou	Eleftheriou	properNoun
Hrisula	Hrisula	properNoun
Accor	Accoutant	properNoun
Ugljanin	Ugljanin	properNoun
Kakanias	Kakanias	properNoun
Dervis	Dervis	properNoun
Aliki	Aliki	properNoun
Sezgin	Se tazgin	properNoun
Aissa	Aissa	properNoun
Gazivoda	Gazivoda	properNoun
Bureto	Bulet	properNoun
Vares	Varié	properNoun
Nezaj	Nezaj	properNoun
Fiorentina	Fiorentina	properNoun
Mitreva	Mitre	properNoun
Sofias	Sfias	properNoun
Costa	Costa	properNoun
Norac	Norac	properNoun
Lupis	Lupis	properNoun
Corlette	Corlette	properNoun
Akyel	Cible	properNoun
Oguro	Oguro	properNoun
Asrim	Asrim	properNoun
Pai	Pai	properNoun
Slavkov	Slavkov	properNoun
Asik	Ask	properNoun
Brefort	Brêle	properNoun
Snjezana	Snjezana	properNoun
Ibish	Ibish	properNoun
Dragoljub	Dragoljub	properNoun
Litvinenko	Litvinenko	properNoun
Gulhan	Gulhan	properNoun
Tufts	Touffes	properNoun
Hafjell	Hafjell	properNoun
Handke	Hommage	properNoun
Budala	Budala	properNoun
Doukas	Doukas	properNoun
Ivanjic	Ivanjic	properNoun
Eleftherotypia	Eleftherotypia	properNoun
KulturAustausch	Kulturaustausch	properNoun
Kurspahic	Kurspahic	properNoun
VaxGen	Vaxgen	properNoun
Blam	Blam	properNoun
Unicredit	Unicredit	properNoun
Montale	Montalité	properNoun
Borussia	Borussie	properNoun
Lojane	Lâche	properNoun
Stojiljkovic	Stojiljkovic	properNoun
Vardari	Vardari	properNoun
Kipkorir	Kipkorir	properNoun
Altis	Altis	properNoun
Zift	Zift	properNoun
Matijevic	Matijevic	properNoun
Cetinelli	Cétinelli	properNoun
Dritan	Dritan	properNoun
Ismajli	Ismajli	properNoun
Gospodnetic	Gospodnétique	properNoun
Arnon	Arnon	properNoun
Lovrjenac	Lovrijenac	properNoun
Bradstreet	Bradstreet	properNoun
Ermelinda	Ermelinda	properNoun
Luljeta	Luljeta	properNoun
Cyclades	Cyclades	properNoun
Amargi	Amargi	properNoun
Uricani	Uricani	properNoun
Klaudija	Klaudija	properNoun
Van Orden	Van orden	properNoun
Sucevita	Sucevita	properNoun
Deraa	Deraa	properNoun
Taksim	Taksim	properNoun
Ekali	Ekali	properNoun
Andis	Et est	properNoun
Leru	Leru	properNoun
Lapon	Lapon	properNoun
Zogaj	Zogaj	properNoun
Szymanski	Szymanski	properNoun
Dengir	Dengir	properNoun
Tekeoglu	Tekoglu	properNoun
Samokov	Samokov	properNoun
Mrdak	MRDAK	properNoun
Haruhiko	Haruhiko	properNoun
Mevludin	Mevludin	properNoun
Bulgargaz	Bulgargaz	properNoun
Susanjin	Susanjin	properNoun
Dhabi	Dabi	properNoun
Muazzez	Muazzez	properNoun
Kalkin	Kalkin	properNoun
Akyol	Akyol	properNoun
Bahram	Bahram	properNoun
Vendemiano	Vendemiano	properNoun
Kosheen	Kosheen	properNoun
Stupni	Stupni	properNoun
Barlad	Barlades	properNoun
Muehlbauer	Muehlbauer	properNoun
Sretenje	Srétenje	properNoun
Neykova	Neykova	properNoun
Salici	Salici	properNoun
Cebalovic	Cebarovic	properNoun
Prevazi	Prevazi	properNoun
Vardis	Vadrouille	properNoun
Grubas	Grudues	properNoun
Igli	Igli	properNoun
Ayasoluk	Ayasoluk	properNoun
Menda	Menda	properNoun
go to	aller à	properNoun
Apostolos	Apostolos	properNoun
Anamaria	Ana Maria	properNoun
Kirova	Kirova	properNoun
Gruskov	Graisseur	properNoun
Patoulidou	Patoulidou	properNoun
Lushine	Lushine	properNoun
Salustro	Salustro	properNoun
Sasa	Sasa	properNoun
Tatsis	Tatsis	properNoun
Hedl	Hedl	properNoun
Ditore	Dite	properNoun
Ballauri	Ballauri	properNoun
Kinofest	Kinofest	properNoun
Slanchogled	Slancoglé	properNoun
Tvornica	TVORNICA	properNoun
Negotino	Négoce	properNoun
Horvat	Horvat	properNoun
Filchev	Filchev	properNoun
Dikli	Dikli	properNoun
Podrinje	Podrinje	properNoun
closing	la clôture	noun
closing	la fermeture	noun
closing	fermeture	None
Khatib	Khatib	properNoun
Dalyanoglu	Dalyanoglu	properNoun
Lavrion	Lavrion	properNoun
Chiren	Chirène	properNoun
Arhin	Arhin	properNoun
Shimadzu	Shimadzu	properNoun
Guli	Guli	properNoun
Nusret	Nusret	properNoun
Rastoder	Rasoder	properNoun
Kartun	Kartun	properNoun
Serpos	Serpos	properNoun
Tanusevci	Tanousevci	properNoun
Alianz	Allianz	properNoun
Simo	Simo	properNoun
Kassimis	Kassimis	properNoun
Blazenko	Blazenko	properNoun
Korac	Kilac	properNoun
Herfkens	Herfkens	properNoun
Cantacuzino	Cantacuzino	properNoun
Waled	Fouetté	properNoun
Turudic	Turudic	properNoun
Constantinos	Constantinos	properNoun
Magazalar	Magazalar	properNoun
Gorani	Gorani	properNoun
Kino	Kino	properNoun
Babanovski	Babanovski	properNoun
Viviccta	Viviccta	properNoun
Otkritie	Otkritie	properNoun
Zemun	Zemun	properNoun
Mikasa	Mikasa	properNoun
Tempus	Tempus	properNoun
Adamopoulou	Adamopoulou	properNoun
Mladevac	Mladevac	properNoun
Loynes	Loynes	properNoun
Haupl	Haupl	properNoun
Albaraka	Albaraka	properNoun
Kostadinova	Kostadinova	properNoun
Radman	Radman	properNoun
Senussi	Senusse	properNoun
Gurau	Gourau	properNoun
Chidesciuc	Chidoisciuc	properNoun
gather pace	prendre de la vitesse	properNoun
Mahcupyan	Mahcupyan	properNoun
ones	celles	properNoun
ones	celles	properNoun
Crnadak	Crnadak	properNoun
Drymades	Drymades	properNoun
Mons	Mons	properNoun
Ozoglu	Ozoglu	properNoun
Berroeta	Berroeta	properNoun
Kubot	Kubot	properNoun
Sagalassos	Sagalassos	properNoun
Buyuklieva	Buyuklieva	properNoun
Slack	mou	adjective
Slack	ballant	adjective
Slack	relâché	adjective
Slack	calme	adjective
Slack	négligent	adjective
Slack	stagnant	adjective
Slack	indolent	adjective
Slack	pas sérieux	adjective
Slack	le mou	noun
Slack	la stagnation	noun
Slack	le poussier	noun
Slack	se relâcher	verb
Slack	Mou	None
Bistret	Bistret	properNoun
Aydabiya	Aydabiya	properNoun
Ileanu	Ileanu	properNoun
Zugic	Zugique	properNoun
Kanchevska	Kanchevska	properNoun
Ulaganja	Ulaganja	properNoun
Daka	Daka	properNoun
Romanovce	Romanovce	properNoun
Sirca	Sirca	properNoun
Lagerbäck	Lagerbäck	properNoun
Takeaki	Takeaki	properNoun
Nazim	Nazim	properNoun
Prusac	Prusac	properNoun
Dizdari	Dizdari	properNoun
Dubrava	Dubrava	properNoun
Gallach	Galcheur	properNoun
Maja	Maja	properNoun
Mecaj	Mecaj	properNoun
Klagenfurt	Klagenfurt	properNoun
Alekperov	Alekperov	properNoun
Velkovska	Velkovska	properNoun
Cadogan	Cadogan	properNoun
Muzar	Muzar	properNoun
Filipovic	Philippe	properNoun
Beyaz	Beyaz	properNoun
Frunzaverde	Fronzaverde	properNoun
Dorotheea	Dorothea	properNoun
Alekseyev	Alekseyev	properNoun
Preokret	Préokret	properNoun
Beslan	Beslan	properNoun
Petkanov	Pékanov	properNoun
Butman	Majorité	properNoun
Erl	Erl	properNoun
Eames	Eames	properNoun
Vucak	Vucak	properNoun
Dujic	Dujic	properNoun
Memish	Memish	properNoun
Alkan	Alcan	properNoun
Sandton	Sandton	properNoun
Ilyushin	Ilyushin	properNoun
Panduraru	Panduraru	properNoun
Ploiest	Ploiesti	properNoun
Marton	Marton	properNoun
Elvedin	Elvedin	properNoun
Seitaridis	Seitaridis	properNoun
Zubce	Zubce	properNoun
Kluivert	Kluivert	properNoun
Abdullatif	Abdullatif	properNoun
Bramerc	Bramerc	properNoun
Ofterschwang	Ofterschwang	properNoun
Csaky	Csaky	properNoun
Arte	Arte	properNoun
Kourkoulas	Kourkoulas	properNoun
Bentinidis	Bentinidis	properNoun
Welle	Se saluer	properNoun
Krynica	Krynica	properNoun
Kollios	Kollios	properNoun
Dorises	Doris	properNoun
Drobnjak	Drobnjak	properNoun
Cernei	Cernei	properNoun
Naanovo	Naanovo	properNoun
Fyssas	Fyssas	properNoun
Ayman	Ayman	properNoun
Bakouris	Bakouris	properNoun
Botler	Botler	properNoun
Feyzullah	Feyzullah	properNoun
Ozgunel	Ozgunel	properNoun
Arges	Arges	properNoun
Starchev	Starchev	properNoun
Dujkovic	Dujkovic	properNoun
Fondiaria	Fonciaria	properNoun
Gabby	jacasseur	adjective
Gabby	bavasson	adjective
Gabby	Jacasseur	None
Niksa	Niksa	properNoun
Bosnjakovic	Bosnjakovic	properNoun
Gojcin	Gojcin	properNoun
Stamenkovska	Stamenkovska	properNoun
Arkas	Arkas	properNoun
Svindal	Svindal	properNoun
Kontinen	Kontinen	properNoun
Ucmak	Ucmak	properNoun
Graffiti	le graffiti	noun
Graffiti	Graffiti	None
Iera	Iera	properNoun
Ogaryovo	Ogaryovo	properNoun
criminal code	code criminel	properNoun
Chand	Cosse	properNoun
Caragiale	Caragier	properNoun
Rados	Radois	properNoun
Makolli	Makolli	properNoun
Ozdener	Ozdener	properNoun
Lucko	Lucko	properNoun
Kucharova	Kucharova	properNoun
Zitiste	Zitiste	properNoun
Dragos	Dragos	properNoun
Zarzuri	Zarzuri	properNoun
Dobjani	Dobjani	properNoun
Senaid	Sénays	properNoun
