Tarja	Tarja	properNoun
Casati	Casati	properNoun
Cepun	Crevin	properNoun
Raider	le raider	noun
Raider	le voleur	noun
Raider	le braqueur	noun
Raider	le commando	noun
Raider	le bombardier	noun
Raider	Raider	None
Roddick	Roddick	properNoun
Tranströmer	Tranströmer	properNoun
Maestro	le maestro	noun
Maestro	Maestro	None
Mosneagu	Mosneagu	properNoun
Arsenijevic	Arsenijevic	properNoun
Muhammadmian	Muhammadmien	properNoun
Euroitalia	Eurotalia	properNoun
Zivkucin	Zivkucin	properNoun
Pasion	Paume	properNoun
Tedi	Tedi	properNoun
Hebros	Hébreux	properNoun
Karan	Karan	properNoun
Primer	l' apprêt	noun
Primer	le livre élémentaire	noun
Primer	le premier livre	noun
Primer	Apprêt	None
Cravinho	Cravinho	properNoun
Aggeletou	Aggelettou	properNoun
Sretan	Srétan	properNoun
Borovcanin	Borovcanin	properNoun
Sirkeci	Sirkeci	properNoun
Nijaz	Nijaz	properNoun
McGuffie	Mcguffie	properNoun
Sredojevic	Sredojevic	properNoun
Drinka	Buveur	properNoun
Altun	Altun	properNoun
Fukui	Fukui	properNoun
Titu	Titu	properNoun
Sanel	Sanel	properNoun
Odartsi	Odartsi	properNoun
Skelane	Skélane	properNoun
Ziller	Zéro	properNoun
Papamichalopoulos	Papamicalopoulos	properNoun
Velinovska	Velinovska	properNoun
Ahdin	Ahdin	properNoun
Llambi	Llambi	properNoun
Von Habsburg	Von habsbourg	properNoun
Vosskuhle	Vosskuhle	properNoun
Lambrianidis	Lambrianidis	properNoun
Cem	Cem	properNoun
Kelmendi	Kelmendi	properNoun
Bozo	Bozo	properNoun
Risan	Risan	properNoun
Selenic	Sélénique	properNoun
Cernenco	Cernenco	properNoun
Debar	interdire	verb
Debar	défendre à faire	verb
Debar	Interdire	None
Carman	Carman	properNoun
Karpuzcu	Karpuzcu	properNoun
Lehel	Lehel	properNoun
Iliadis	Iliadis	properNoun
Grancharova	Grandarova	properNoun
Kazichene	Kazichene	properNoun
Dindane	Dindane	properNoun
Nazif	Nazif	properNoun
Liosia	Liosité	properNoun
Bair	Bair	properNoun
Ninoslav	Ninoslave	properNoun
Cortic	Cortic	properNoun
Irakleio	Irakleio	properNoun
Kovesi	Kovesi	properNoun
Stelliatos	Stelliatos	properNoun
Ramadani	Ramadani	properNoun
Hvar	Hvar	properNoun
Citroen	Citroen	properNoun
Greguric	Grégurique	properNoun
Altintop	Alternatif	properNoun
Mittelmoda	Mittelmoda	properNoun
Kocovski	Kocovski	properNoun
Kenichi	Kenichi	properNoun
Znjan	Znjan	properNoun
Ergin	Ergine	properNoun
Modrici	Modic	properNoun
Bilan	Bilan	properNoun
Hakan	Hakan	properNoun
Verdechi	Verdechi	properNoun
Gazela	Gazela	properNoun
Nikolaevich	Nikolaevich	properNoun
Petrich	Pétrole	properNoun
Duvnjak	Duvnjak	properNoun
Danforth	Danforth	properNoun
Nollas	Nollas	properNoun
Perianu	Périanu	properNoun
Tanui	Tanui	properNoun
Icli	ICli	properNoun
Myrdal	Mydal	properNoun
Mladineo	Mladineo	properNoun
Nedjeljko	Nedjeljko	properNoun
Vladan	Vladan	properNoun
Maniani	Manianie	properNoun
Frischenschlager	Frischenschlager	properNoun
Saftoiu	Safeoiu	properNoun
Hatay	Hatay	properNoun
Zampelas	Zampelas	properNoun
Bazargan	Bazargan	properNoun
Fico	Fico	properNoun
Salmi	Salmi	properNoun
Pajazitit	Pyjazité	properNoun
Vidachim	Vidac	properNoun
Kiroska	Kiroska	properNoun
Barbu	Barbu	properNoun
Bushati	Bushati	properNoun
Milivoj	Milivoj	properNoun
Bilgi	Bilgi	properNoun
Kebo	Kebbo	properNoun
Azina	Azina	properNoun
Skadar	Skadar	properNoun
Dunev	Dunev	properNoun
Topi	Topi	properNoun
Guno	Guno	properNoun
Emmezette	Emmette	properNoun
Petros	Pétros	properNoun
Electrabel	Electrique	properNoun
Tajani	Tajani	properNoun
Henricus	Henricus	properNoun
Mahcupyen	Mahcupyen	properNoun
Miladinov	Miladinov	properNoun
Marcadier	Marcadier	properNoun
Lirim	Lirim	properNoun
Schalke	Schalke	properNoun
Nitaj	Nitaj	properNoun
Biba	Biba	properNoun
Flinders	Flinders	properNoun
Konomi	Konomi	properNoun
Mahalli	Mahalli	properNoun
Stecak	Style	properNoun
TransConflict	Transconnier	properNoun
Kuzu	Kuzu	properNoun
Gece	Gece	properNoun
Orman	Orman	properNoun
Gulcan	Golcan	properNoun
Senad	Senad	properNoun
Zoltan	Zoltan	properNoun
Rugrats	Rugles	properNoun
Doamne	Doamne	properNoun
Recica	Se réjouir	properNoun
Rasce	Rascer	properNoun
Mostarsko	Latarsko	properNoun
Pamukkale	Pamukkale	properNoun
Leschiov	Leschiov	properNoun
Tsonko	Tsonko	properNoun
Ikiztepe	Ikiztepe	properNoun
Mihelakis	Mihelakis	properNoun
Kukumi	Kukumi	properNoun
Krstev	Krstev	properNoun
Sejil	Sejil	properNoun
Hasirci	Hasiriri	properNoun
Luso	Luso	properNoun
Jap	Jap	properNoun
Spinu	Épineux	properNoun
Gano	Gano	properNoun
Kelani	Kelani	properNoun
Komiza	Komiza	properNoun
Stimlje	Stimlje	properNoun
Emeritus	émérite	adjective
Emeritus	honoraire	adjective
Emeritus	Émérite	None
Tomi	Tomi	properNoun
Giolias	Giolies	properNoun
Oste	Oste	properNoun
Ilker	Ilker	properNoun
Radan	Radan	properNoun
Dourlot	Dourlot	properNoun
Rafaele	Rafaele	properNoun
Lear	Apprendre	properNoun
Taik	Taïk	properNoun
Lungulov	Lungulov	properNoun
Omonia	Omonie	properNoun
Pocanic	Pocanique	properNoun
Simonoski	Simonoski	properNoun
Burduja	Burduja	properNoun
Netzer	Netzer	properNoun
Stankov	Stankov	properNoun
Ornek	Ornek	properNoun
Akif	Akif	properNoun
Sedivy	Se sécher	properNoun
Badia	Badia	properNoun
Vostok	Vostok	properNoun
Eurobasket	Eurobasket	properNoun
Preisner	Preisner	properNoun
Skaricic	Skaricic	properNoun
Avdyli	Avdyli	properNoun
Funar	Funar	properNoun
Orlice	Orlice	properNoun
Stroie	Strie	properNoun
Udovicki	Udovicki	properNoun
Drustinac	Drustinac	properNoun
Mitsotakis	Mitsotakis	properNoun
Caglavica	Caglavica	properNoun
Nakov	Nakov	properNoun
Kicevo	Kicevo	properNoun
Sehapi	Sehapi	properNoun
Buckovski	Buckovski	properNoun
Boel	Boulon	properNoun
Roano	Rotano	properNoun
Cobovski	Cobovski	properNoun
Bodur	Bodur	properNoun
Hadise	Endommagé	properNoun
work place	lieu de travail	properNoun
Knin	Laver	properNoun
Olaszag	Olaszag	properNoun
Minco	Minoco	properNoun
Graca	Graca	properNoun
Pecanac	Pecanac	properNoun
Budva	Budva	properNoun
Gerdzhikov	Gerdzhikov	properNoun
Valtellina	Valtellina	properNoun
Ularu	Uluru	properNoun
Keratea	Kératea	properNoun
Bruska	Bruska	properNoun
Drews	Drews	properNoun
Kocijancic	Kocijancic	properNoun
Stole	l' étole	noun
Stole	l' écharpe	noun
Stole	A volé	None
Vlatka	Vlatka	properNoun
Gent	le gentleman	noun
Gent	le Monsieur	noun
Gent	le type	noun
Gent	Gent	None
Melathron	Mélathronique	properNoun
Cihan	Citerne	properNoun
Sovjan	Sovjan	properNoun
Beyt	Beyt	properNoun
Szekeres	Szekers	properNoun
Chiscani	Chiscani	properNoun
Scaglione	Scaglione	properNoun
Binali	Binali	properNoun
Cartlidge	Cartlidge	properNoun
chief executive officer	chef de la direction	properNoun
Chonevski	Chonevski	properNoun
Suncani	Suncani	properNoun
Mickovski	Mickovski	properNoun
Previn	Prévenir	properNoun
Danuta	Danuta	properNoun
Tavo	Tavo	properNoun
Rojs	ROJS	properNoun
Mobifon	MOBIFON	properNoun
Pastina	pastina	properNoun
Raicea	Racea	properNoun
Fevzi	Fevzi	properNoun
Aysegul	Aysegul	properNoun
Skopljak	Skopljak	properNoun
Lesnikovska	Lesnikovska	properNoun
Gizia	Gizia	properNoun
Volou	Volou	properNoun
Tzarevo	Tzarevo	properNoun
Obeidi	Obéidi	properNoun
Geir	Geir	properNoun
Starbucks	Starbucks	properNoun
Euinside	Euinside	properNoun
Dikme	Dikme	properNoun
Stardelov	Stardelov	properNoun
Kerhanaj	Kerhanaj	properNoun
Strela	Strela	properNoun
Blagoja	Blagoja	properNoun
Kuret	Kuret	properNoun
Euromagazin	Euromagazine	properNoun
KosovaInfest	Kosovainfest	properNoun
Niko	Niko	properNoun
Antek	Antek	properNoun
Borovec	Borovec	properNoun
Economides	Économes	properNoun
Athanassios	Athanassios	properNoun
Kraljicina	Kraljicine	properNoun
Caleta	Caléta	properNoun
drive away	chasser	verb
drive away	éloigner	verb
drive away	démarrer	verb
drive away	s'en aller en voiture	None
Miomir	Miomir	properNoun
Pocar	Pocar	properNoun
Benevolencija	Benevolencija	properNoun
Cristel	Cristel	properNoun
Husi	Husi	properNoun
Rushaidat	Rushaidat	properNoun
Vladimirov	Vladimirov	properNoun
Alona	Alona	properNoun
Uffe	Uffe	properNoun
Mitchek	Mitchek	properNoun
Rustiko	Rustiko	properNoun
Lushtaku	Lushtaku	properNoun
Drougos	Drougos	properNoun
Figaro	Figaro	properNoun
Oyunculari	Oyunculari	properNoun
Saso	Saso	properNoun
Gulsov	Guique	properNoun
Aventis	Aventis	properNoun
Vicky	Vicky	properNoun
Mediapro	Mediapro	properNoun
Draze	Lâcher	properNoun
Kleybanova	Kleybanova	properNoun
Polt	Polt	properNoun
Alemitu	Alémitu	properNoun
Kamberion	Kamberion	properNoun
Sicario	Sicario	properNoun
Bozyel	Bozyel	properNoun
Pisari	Pisari	properNoun
Iyad	Iyad	properNoun
Shpetim	Shpetim	properNoun
Borce	Borcé	properNoun
Duhles	Duhles	properNoun
Belousovova	Belousovova	properNoun
Bukovica	Bukovica	properNoun
Reppas	Repass	properNoun
Asylo	Asylo	properNoun
Bosnalijek	Bosnalijek	properNoun
Aktor	Aktor	properNoun
Hablemitoglu	Hablemitoglu	properNoun
Hrasnica	Hrasnica	properNoun
Kelesidou	Kelesidou	properNoun
Orizont	Orizont	properNoun
Karakousis	Karakousis	properNoun
Iraklion	Iraklion	properNoun
Rabbani	Rabbani	properNoun
Hudazin	Huzine	properNoun
Klishevska	Klishevska	properNoun
Haliassos	Haliassos	properNoun
Brydon	Brydon	properNoun
Talevska	Talevska	properNoun
Allahverdi	Allahatverdi	properNoun
Ecemis	Ecemis	properNoun
Paraschiv	Parasche	properNoun
Kitova	Kitova	properNoun
Butterfield	Butterfield	properNoun
Bicanin	Bicanine	properNoun
Aidavita	Aidavita	properNoun
Mumcu	Mumdu	properNoun
Amed	Amé	properNoun
Novosel	Novosel	properNoun
Sadr	Sadr	properNoun
Shpat	Shpat	properNoun
Asterfest	Asterfest	properNoun
Fyodor	Fyodor	properNoun
Alija	Alija	properNoun
Andic	Anique	properNoun
Kalmeta	Kalméta	properNoun
Maryetta	Mariette	properNoun
Banerji	Banerji	properNoun
Keiji	Keiji	properNoun
Neruda	Neruda	properNoun
Swissinfo	Swissinfo	properNoun
Binbir	Binbir	properNoun
Tandara	Tanara	properNoun
Mironova	Mirant	properNoun
Efendija	Efendija	properNoun
Andrija	Andrija	properNoun
Krupa	Krupa	properNoun
six-year	six ans	properNoun
Demrici	Demirci	properNoun
Minarolli	Minarollis	properNoun
Drobac	Drobac	properNoun
Bonze	le bonze	noun
Bonze	Bonze	None
Ozgurcan	Ozgurcan	properNoun
Reklamcilik	Reklamcilik	properNoun
Gogos	Gogos	properNoun
Golfinopoulou	Golfinopoulou	properNoun
Schlegel	Schlegel	properNoun
Nanking	Nanking	properNoun
Kasumatis	Kasumatis	properNoun
Muhal	Muhalique	properNoun
Valbona	Valbona	properNoun
Lazarov	Lazarov	properNoun
Aeroport	Aéroport	properNoun
Fidosova	Fidosova	properNoun
Simerini	Simerini	properNoun
Darik	Darik	properNoun
Hrabak	Hrabak	properNoun
Savudria	Savudrija	properNoun
Kapetani	Kapétatani	properNoun
Vlaisavljevic	Vlaisavljevic	properNoun
Hatzidakis	Hatzidakis	properNoun
Ezgi	Ezgi	properNoun
Prevaza	Préveza	properNoun
Karaiskaki	Karaiskaki	properNoun
Tsoulis	Tsoulis	properNoun
Skalusevic	Skalusevic	properNoun
Ermione	Ermione	properNoun
Reinfeldt	Reinfeldt	properNoun
Herschell	Herschell	properNoun
Kalogeresis	Kalogerèse	properNoun
Pinjatic	Pinçant	properNoun
Talcott	Talcott	properNoun
Trajkovska	Trajkovska	properNoun
Koutroumanis	Koutroumanis	properNoun
Catarama	Catarama	properNoun
Mihalj	Mihalj	properNoun
Tomcat	le matou	noun
Tomcat	courir les filles	verb
Tomcat	Matou	None
Ulvija	Ulvija	properNoun
Leskovac	Leskovac	properNoun
Ovcharov	Ovcharov	properNoun
Karantasiou	Karantasiou	properNoun
Anthropo	Anthropo	properNoun
Pavlos	Pavlos	properNoun
Fiscuteanu	Fisctueanu	properNoun
Gherghina	Germina	properNoun
Behramaj	Behramaj	properNoun
Leguri	Légumes	properNoun
Michalakis	Michalakis	properNoun
Gardabani	Gardabani	properNoun
Zoro	Zoro	properNoun
Transnafta	Transnafta	properNoun
many of	un grand nombre de	properNoun
Interforze	Interférer	properNoun
Laszo	Laszlo	properNoun
Sladjan	Sladjan	properNoun
Krstomir	Krstomir	properNoun
Pamukova	Pamukova	properNoun
Jessen	Jessen	properNoun
Neptun	Neptun	properNoun
Ahmici	Ahmici	properNoun
Kalfin	Kalfin	properNoun
Georgakopoulos	Georgakopoulos	properNoun
Azize	Azize	properNoun
Ultrason	Ultrason	properNoun
Ordev	Ordev	properNoun
Belogradchik	Belogradchik	properNoun
Milenijum	Milenijum	properNoun
Kissiov	Kissiov	properNoun
Angeloska	Angeloska	properNoun
Torcida	Torcida	properNoun
valuable	précieux	adjective
valuable	de valeur	adjective
valuable	de grande valeur	adjective
valuable	de grand prix	adjective
valuable	l' objet de valeur	noun
valuable	précieux	None
Patozi	Patozi	properNoun
Pandur	Pandureur	properNoun
Hadzic	Hadzic	properNoun
Zarouchla	Zarouchla	properNoun
Nesrin	Nesrin	properNoun
in contrast to	contrairement à	properNoun
Ristanovic	Ristanovic	properNoun
Hribar	Hribar	properNoun
Ozdil	Ozdil	properNoun
Mavriqi	Mavriqi	properNoun
Cavli	Cavli	properNoun
Mladen	Mladen	properNoun
Vogli	Vogli	properNoun
Glina	Glina	properNoun
Aa	Aa	properNoun
Bosko	Bosko	properNoun
Pancevo	Pancevo	properNoun
Galevgrad	Galevgrad	properNoun
Stada	Stade	properNoun
Trygve	Trygve	properNoun
Lusic	Lusieux	properNoun
Sigura	Sigura	properNoun
Slanina	Slanina	properNoun
Mavrovo	Mavrovo	properNoun
Blagojce	Blagojce	properNoun
Fikret	Fikret	properNoun
Zvecani	Zvecani	properNoun
Centrale	Centrale	properNoun
Bubachki	Bubachki	properNoun
Oltean	Oltean	properNoun
Bouloukbasi	Bouloukbasi	properNoun
Korenkiewicz	Korenkiewicz	properNoun
Tsilla	Tsilla	properNoun
Nuno	Nuno	properNoun
Crikvenica	Crikvenica	properNoun
Rasnov	Rasé	properNoun
Turkdogan	Turkdogan	properNoun
take effect	faire son effet	verb
take effect	prendre son effet	verb
take effect	prendre effet	None
Mumin	Mumin	properNoun
Trodon	A foulé	properNoun
Kazakov	Kazakov	properNoun
Asen	Asen	properNoun
Kuru	Kuru	properNoun
Interfest	Interférer	properNoun
Hosseini	Hosseini	properNoun
Kovacevica	Kovacevica	properNoun
Angelopoulou	Angelopoulou	properNoun
Zadar	Zadar	properNoun
Niznji	Niznji	properNoun
Gavran	Gavran	properNoun
Caransebes	Caransebes	properNoun
Zeki	Zeki	properNoun
Vjesnik	Vjesnik	properNoun
Orgocka	Orgocka	properNoun
Vukomanovic	Fukomanovic	properNoun
Macrocosmos	Macrocosmos	properNoun
Dajci	Dajci	properNoun
Filipestii	Filipetii	properNoun
Ruse	la ruse	noun
Ruse	le stratagème	noun
Ruse	Ruse	None
Taymaz	Taymaz	properNoun
Zeneli	Zeneli	properNoun
Cutescu	Creescu	properNoun
Valjon	Valjon	properNoun
Rigalis	Rigalis	properNoun
Chayton	Chayton	properNoun
Bozicnica	Bozicnica	properNoun
Karadjordjevo	Karadjordjevo	properNoun
Interclima	Interclima	properNoun
Blerim	Bière	properNoun
Kutev	Kutev	properNoun
Venol	Venol	properNoun
Mirusha	Mirusha	properNoun
Zakosek	Zakosek	properNoun
Wifried	Wifried	properNoun
Graf	Graft	properNoun
Kuznezova	Kuznetsova	properNoun
Posidonas	Posidonas	properNoun
Ymeri	Ymeri	properNoun
Pandev	Pandev	properNoun
Soray	Soray	properNoun
Commenius	Comenius	properNoun
CineLink	Cinéque	properNoun
Rosselkhoznadzor	Rosselkhoznadzor	properNoun
Orphaned	orphelin	adjective
Orphaned	Orphelin	None
Ponomarenko	Ponomarenko	properNoun
Cerrik	Cerrik	properNoun
Gokcek	Gokcek	properNoun
Gori	Gori	properNoun
Dyo	Dyo	properNoun
Eto	ETO	properNoun
Fjord	le fjord	noun
Fjord	Fjord	None
Behixudin	Behixudin	properNoun
Bryza	Bryza	properNoun
Mrdja	MRDJA	properNoun
Gunasuy	Gunasuy	properNoun
Condratchi	Condorque	properNoun
Muzat	Muzat	properNoun
Keremedchiev	Keremedchiev	properNoun
Pakostane	Pakostane	properNoun
Ventsislav	Ventsislav	properNoun
Vizion	Viande	properNoun
Plodnost	Plodnost	properNoun
Darijo	Darijo	properNoun
Buro	Buro	properNoun
Stijovic	Stijovic	properNoun
Hajrullahu	Hajrullahu	properNoun
run into	rencontrer	verb
run into	tomber sur	verb
run into	atteindre	verb
run into	retrouver	verb
run into	rencontrer par hasard	verb
run into	rentrer	verb
run into	s'heurter	verb
run into	s'heurter à	verb
run into	s'élever à	verb
run into	percuter	None
Omerfendic	Omerfendic	properNoun
Sahiti	Sahiti	properNoun
Fibelfin	Fibrelfin	properNoun
Vasko	Vasko	properNoun
Liburnia	Liburnia	properNoun
Bartenstein	Bartenstein	properNoun
Kukeli	Kukeli	properNoun
Amichai	Amichai	properNoun
Pandza	Pandza	properNoun
Miskin	Méchant	properNoun
Zobel	Zobel	properNoun
Dainov	Dainov	properNoun
Ajvazi	Ajvazi	properNoun
Shqipe	Shqipe	properNoun
Orahovac	Orahovac	properNoun
Fourmont	Quinvermont	properNoun
Stepanek	Stepanek	properNoun
Sugarev	Sucreev	properNoun
Stoiber	Piquant	properNoun
Berwada	Berwada	properNoun
Kutlug	Kutlug	properNoun
Goggin	Goggin	properNoun
Mtel	Mtel	properNoun
Pocitelj	Pocitelj	properNoun
Gusa	Gusa	properNoun
Gestapo	le gestapo	noun
Gestapo	Gestapo	None
Hristo	Hristo	properNoun
Ciftci	Ciftci	properNoun
Grozdeva	Grozdeva	properNoun
Kayseri	Kayseri	properNoun
Tubic	Tubique	properNoun
Panathinaikon	Pancathinaïkos	properNoun
Bozaj	Bozaj	properNoun
Kovacica	Kovacica	properNoun
Lotto	le loto	noun
Lotto	Loto	None
Goati	Goati	properNoun
Melinescu	Melinescu	properNoun
Ziver	Ziver	properNoun
Prec	Précaire	properNoun
Poli	Poli	properNoun
Silopi	Silopi	properNoun
Shkrbina	Shkrbina	properNoun
Plougchieva	Plougchieva	properNoun
Nord	Nord	properNoun
Cafer	Cafeur	properNoun
Seabourn	Marin	properNoun
Mehmed	Meurtré	properNoun
Mioveni	Mioven	properNoun
Rochus	Rochus	properNoun
Slamkov	Slamkov	properNoun
Aegis	l' égide	noun
Aegis	Égide	None
Eugen	Eugen	properNoun
Elezit	Elezit	properNoun
Paraskevopoulou	Paraskevopoulou	properNoun
Kaori	Kaori	properNoun
Flamur	Flamure	properNoun
Melinte	Mélinte	properNoun
Krushare	Krushare	properNoun
Sarayici	Sarayici	properNoun
Siirt	Siirt	properNoun
Naif	Natif	properNoun
Bolcas	Bolcas	properNoun
Milkovic	Milkovic	properNoun
Telluride	Telluride	properNoun
Vişeu	Vişeu	properNoun
Besimi	Besimi	properNoun
Cemil	Cemil	properNoun
Gungor	Gunde	properNoun
Miric	Mirical	properNoun
Semi	Semi	properNoun
Rudaw	Rudaw	properNoun
Basit	Basot	properNoun
Rizvic	Rizvic	properNoun
Blace	Blague	properNoun
Derya	Derya	properNoun
Bomberger	Bombardier	properNoun
Kryedrini	Kryédrini	properNoun
Svaljek	Svaljek	properNoun
Rafail	Rafil	properNoun
Sima	Sima	properNoun
Pavlopetri	Pavlopetri	properNoun
Kolede	Kolede	properNoun
Toncev	Tonnev	properNoun
Romed	Romain	properNoun
Sagan	Sagan	properNoun
Pjeter	Pjeter	properNoun
Hadith	Hadith	properNoun
Mandache	Mandat	properNoun
Constanta	Constanta	properNoun
Pecelj	Pecelj	properNoun
Preventative	préventif	adjective
Preventative	Préventif	None
Valea	Valet	properNoun
Vingas	Vingt	properNoun
Krstulovic	Krstulovic	properNoun
Kadino	Kadino	properNoun
Vakifbank	Vakifbank	properNoun
Gymnich	Gymnich	properNoun
Hadjicostis	Hadjicostis	properNoun
Akil	Akil	properNoun
Astarastoaie	Astarastoaie	properNoun
Vseki	Vseki	properNoun
Chandrayaan	Chandrayaan	properNoun
Birac	Birac	properNoun
Kroef	Kroef	properNoun
deblock	débloquer	properNoun
Placid	placide	adjective
Placid	calme	adjective
Placid	serein	adjective
Placid	Placide	None
Maxi	Maxi	properNoun
Boya	Boya	properNoun
Bozinovici	Bozinovici	properNoun
Butu	Butin	properNoun
Derekoy	Derekoy	properNoun
Koimomeni	Koimomeni	properNoun
Binaku	Binaku	properNoun
Trtar	Trempe	properNoun
Rotella	Rotella	properNoun
Ozer	Ozer	properNoun
Shkendija	Shkendija	properNoun
Barbaso	Barbaso	properNoun
Vaitiekunas	Vaitiekunas	properNoun
Babos	Babos	properNoun
Okcali	Okcali	properNoun
Kuneshka	Kuneshka	properNoun
Minodora	Minodrora	properNoun
Suker	Suker	properNoun
Dodik	Dodik	properNoun
Bashi	Bashi	properNoun
Videomedeja	Videomedeja	properNoun
Panagiotakos	Panagiotakos	properNoun
Diamantidis	Diamantidis	properNoun
Everers	Everers	properNoun
Titan	le Titan	noun
Titan	Titan	None
Mikkelsen	Mikkelsen	properNoun
Papantoniou	Paperoniou	properNoun
Rafal	Rafal	properNoun
Arcelik	Arcelik	properNoun
Pipero	Pipéroteur	properNoun
Pantelejmon	Pantelejmon	properNoun
Cenusa	Cenusa	properNoun
Voridis	Voridis	properNoun
Misha	Misha	properNoun
Kilkis	Kilkis	properNoun
Rika	Rika	properNoun
Kizilkaya	Kizilkaya	properNoun
Roksped	Raguté	properNoun
Isturiz	Isturiz	properNoun
Mwijarubi	Mwijarubi	properNoun
Netron	Nettron	properNoun
Vulturu	Vulturu	properNoun
Petrina	Petrina	properNoun
Taye	Taye	properNoun
Hinofotis	Hinofotis	properNoun
Srdjan	Srdjan	properNoun
Ikitelli	Ikitelli	properNoun
Tufekci	Tufekci	properNoun
Kotoulas	Kotoulas	properNoun
Vitoratou	Vitoratou	properNoun
Haxhia	Haxhia	properNoun
Ricciardone	Ricciard	properNoun
Kuzminovi	Kuzminovi	properNoun
Balazs	Balazes	properNoun
Bajqina	Bajqina	properNoun
Redi	Redi	properNoun
Pancev	Purev	properNoun
Bastinac	Bastinac	properNoun
Bucovina	Bucovine	properNoun
Pobjeda	Pobjeda	properNoun
Brajic	Brajic	properNoun
Popovich	Popovich	properNoun
Papaconstantinou	Papaconstantinou	properNoun
Peka	Peuka	properNoun
Kifissia	Kifissia	properNoun
Ekonomisti	Ekonomisti	properNoun
Altayli	Altayli	properNoun
Zijah	Zijah	properNoun
Aliberaj	Aliberaj	properNoun
Guner	Guner	properNoun
Osdil	Osdil	properNoun
Tosh	les bêtises	noun
Tosh	les blagues	noun
Tosh	Top	None
Andrle	Andrle	properNoun
Paltinis	Paltinis	properNoun
Cardinale	Cardinale	properNoun
Minovski	Minovski	properNoun
Radevic	Radical	properNoun
Ermou	Ermou	properNoun
Eni	Eni	properNoun
Trinu	Trinu	properNoun
Hasandedic	Hasandédic	properNoun
Pellegrini	Pellegrini	properNoun
Bata	Bata	properNoun
Axgin	Axfule	properNoun
Georgieva	Georgieva	properNoun
Leyla	Leyla	properNoun
Sotre	Sot	properNoun
Volan	Volan	properNoun
Dimitrios	Dimirios	properNoun
Lurie	Lurie	properNoun
Tsushima	Tsushima	properNoun
Serif	Serif	properNoun
Despotiko	Despotiko	properNoun
Hayman	Hayman	properNoun
Vermica	Vermica	properNoun
Cosea	Cosea	properNoun
Paunova	Paunova	properNoun
Sapnas	Sapnas	properNoun
Compagnia	Compagnie	properNoun
Kolinska	Kolinska	properNoun
Nemcsics	Némcsics	properNoun
Agia	Agia	properNoun
Nekra	Nekra	properNoun
Tafa	Tafa	properNoun
Lupak	Lupak	properNoun
Strugar	Strugar	properNoun
Trafalis	Trafalis	properNoun
Nobuo	Nobuo	properNoun
Blatt	Blatt	properNoun
Starova	Starova	properNoun
Kileva	Kreva	properNoun
Stoitcheva	Stoiperva	properNoun
Dialoghi	Dialoghi	properNoun
Zasad	Zasad	properNoun
Bruguiere	Bruguiere	properNoun
Nexhat	Nexhat	properNoun
Lehne	Lehne	properNoun
elimate	éliminer	verb
elimate	supprimer	verb
elimate	écarter	verb
elimate	exclure	verb
elimate	négliger	verb
elimate	éliminer	None
Srbijagas	Srbijagas	properNoun
Lence	Lence	properNoun
Merja	Merja	properNoun
Lockerbie	Casierbie	properNoun
Marinos	Marinos	properNoun
Gligorov	Gligorov	properNoun
Dagi	Dagi	properNoun
Nelspruit	Nelspruit	properNoun
Ertaç	Ertaç	properNoun
Harnoncourt	Harnoncourt	properNoun
Costache	Hasard	properNoun
Inpress	Dans la presse	properNoun
Pulumur	Pulmonier	properNoun
Spirescu	Silcucu	properNoun
Beregovaya	Beregovaya	properNoun
Djabe	Djabe	properNoun
Suzer	Suzer	properNoun
Svrgovski	Swarovski	properNoun
Motoc	Motoc	properNoun
control oneself	maîtriser	verb
control oneself	se contrôler	None
Plemetina	Plémètre	properNoun
Bungur	Bungure	properNoun
Hama	Hama	properNoun
Pasi	Pasi	properNoun
Gradacac	Graduacac	properNoun
Nezaboravak	Nezaboravak	properNoun
Shehi	Shehi	properNoun
Rigal	Rigal	properNoun
Darwish	Darwish	properNoun
Mirhunisa	Mirhunisa	properNoun
Holanda	Holanda	properNoun
Gabar	Gabar	properNoun
Babii	Babii	properNoun
Mitropoulos	Mitropoulos	properNoun
Georgoussis	Géorgoussaine	properNoun
Flueras	Flueras	properNoun
Rumen	le rumen	noun
Rumen	la panse	noun
Rumen	Rumen	None
Moanta	Moanta	properNoun
Moracanin	Moracanine	properNoun
Farhad	Farfelu	properNoun
Oprisor	Oprisor	properNoun
Rios	Rios	properNoun
Eurosong	Euros	properNoun
Dabarcic	Dabcique	properNoun
Fraskeric	Frasquer	properNoun
Botticelli	Botticelli	properNoun
self-accuse	auto-accusation	properNoun
fraternise	fraterniser	properNoun
Zagorje	Zagorje	properNoun
Navratilova	Navratilova	properNoun
Gunel	Gunel	properNoun
Kristiana	Kristiana	properNoun
MediDent	Médiocre	properNoun
Dimitrovgrad	Dimitrovgrad	properNoun
Zubak	Zubak	properNoun
Boheme	Bohème	properNoun
Palacol	Palacol	properNoun
Haier	Haier	properNoun
Psomiades	Psomiades	properNoun
Mihalascu	Mihalascu	properNoun
Velioglu	Velioglu	properNoun
just a little	juste un peu	properNoun
Radojkovic	Radojkovic	properNoun
Oancea	Oancea	properNoun
Karakamiseva	Karakamiseva	properNoun
Smaka	Smaka	properNoun
Ozkaya	Ozkaya	properNoun
Karavasili	Karavasili	properNoun
Shigeo	Shigeo	properNoun
Centavia	Centavia	properNoun
Kontevska	Kontevska	properNoun
Murgasova	Murgasova	properNoun
Tatzmannsdorf	Tatzmannsdorf	properNoun
Tankov	Tankov	properNoun
Perescu	Percucu	properNoun
Kirijas	Kirijas	properNoun
Demre	Demi	properNoun
Samand	Samand	properNoun
Dukagjini	Dukagjini	properNoun
Lupsa	Lubsa	properNoun
Spehar	Spehar	properNoun
Avenir	Avenir	properNoun
Evangelos	Évangélos	properNoun
Molodist	Molodiste	properNoun
Solon	Solon	properNoun
Binyamin	Binyamin	properNoun
Mukhatzhanova	Mukhatzhanova	properNoun
Vianu	Vianu	properNoun
Bakr	Bakr	properNoun
Nihad	Nihad	properNoun
Grobnik	Grobnik	properNoun
Shikoh	Shikoh	properNoun
Ilir	Ilir	properNoun
Promo	Promo	properNoun
Trigranit	Trigranité	properNoun
Lajme	Lajme	properNoun
Dobrusa	Dobrusa	properNoun
Mosul	Mouscul	properNoun
Matsumoto	Matsumoto	properNoun
Nesimi	Nesimi	properNoun
Grubjesic	Grubjesic	properNoun
Stadthalle	Stadthalle	properNoun
Iraklio	Iraklio	properNoun
Graikos	Grakos	properNoun
Mozgalo	Mozgalo	properNoun
Cene	Cene	properNoun
Zatriqi	Zatriqi	properNoun
Nwankwo	Nwankwo	properNoun
Keskoski	Keskoski	properNoun
Cvikl	Cvikl	properNoun
Zaykova	Zaykova	properNoun
Giorgos	Giorgos	properNoun
Jos	Jos	properNoun
Tsanchev	Tsanchev	properNoun
Raicho	Raicho	properNoun
Miteva	Mitesva	properNoun
Hazim	Hazim	properNoun
Radmila	Radmila	properNoun
Bogujevci	Bogujevci	properNoun
Panionios	Panionios	properNoun
Tipton	Tipton	properNoun
Muja	Muja	properNoun
Viduka	Viduka	properNoun
Hamed	Hamed	properNoun
Plaka	Plaquée	properNoun
Lechkov	Lechkov	properNoun
Siveco	Siveco	properNoun
Ignatov	Ignatoud	properNoun
Vane	la girouette	noun
Vane	la pale	noun
Vane	l' aile	noun
Vane	Girouette	None
Shtylla	Shtylla	properNoun
Hoshe	Hospitalier	properNoun
Rato	Rato	properNoun
Bastic	Bison	properNoun
Mishri	Mishri	properNoun
Heartefact	Heartfact	properNoun
Perisor	Périseur	properNoun
Portoroz	Portoroz	properNoun
Cseke	Cleeke	properNoun
Kalev	Kalev	properNoun
Tenzing	Timide	properNoun
Alecu	Alecu	properNoun
butchering	massacrer	verb
butchering	égorger	verb
butchering	abattre	verb
butchering	tuer	verb
butchering	boucher	None
Karanfilov	Karanfilov	properNoun
Mljet	Mljet	properNoun
Enste	Enste	properNoun
Burov	Burov	properNoun
Lisen	Lisen	properNoun
Novica	Novica	properNoun
Toptan	Toptan	properNoun
Latifi	Latifi	properNoun
Klestil	Klakestil	properNoun
Chengene	Chengene	properNoun
Engdahl	Engdahl	properNoun
Anamarija	Anamarija	properNoun
Karadjova	Karadjova	properNoun
Radmacher	Radmacher	properNoun
Pahigian	Pahigien	properNoun
Internazionale	Internazionale	properNoun
Nicolaescu	Nicolaescu	properNoun
Nerma	Nerma	properNoun
Cupru	Cupru	properNoun
Sukobina	Sukobina	properNoun
Andrikakis	Andrikakis	properNoun
Cikatic	Cikatique	properNoun
Iletisim	Iletisim	properNoun
Kaheh	Kaheh	properNoun
Ndou	Ndou	properNoun
Papanastasiou	PapanastaSiou	properNoun
Ermal	Ermal	properNoun
Bodin	Bodin	properNoun
Tata	Tata	properNoun
Carrisi	Carisi	properNoun
Maliqi	Maliqi	properNoun
Memisevic	Memisevic	properNoun
Klammer	Klammer	properNoun
Idin	Idiot	properNoun
Memnune	Memnune	properNoun
Activ	Idiot	properNoun
Limassol	Limassol	properNoun
Suljevic	Suljevic	properNoun
Braca	Braca	properNoun
Blagica	Blagica	properNoun
Moni	Moni	properNoun
Akiko	Akiko	properNoun
Poletan	Polétaine	properNoun
Tojaga	Tojaga	properNoun
Badza	Badza	properNoun
Anka	Anka	properNoun
Obrovac	Obrovac	properNoun
Hrvatske	Hrvatske	properNoun
Freden	Freden	properNoun
Varoslija	Varoslija	properNoun
Bredtmann	Bredtmann	properNoun
Milanovic	Milanovic	properNoun
Esat	Esat	properNoun
Sehir	Sehir	properNoun
Racho	Racho	properNoun
Lukomir	Lukomir	properNoun
Abdilacim	Abdilacim	properNoun
Auer	Auer	properNoun
Sokmensuer	Sokmensuer	properNoun
Kagithane	Kagithane	properNoun
Elektronik	Elektronik	properNoun
Vassiliko	Vassiliko	properNoun
Steafnovska	Stumenovska	properNoun
Universum	Universum	properNoun
Vezhinov	Vezhinov	properNoun
Vaskov	Vaskov	properNoun
Abduraman	Abduraman	properNoun
Lugoj	Lugoj	properNoun
Felicea	Felicea	properNoun
Slavoljub	Slavoljub	properNoun
Higl	Higl	properNoun
Diakofto	Diakofto	properNoun
Komadic	Komadic	properNoun
Maslovaric	Maslovarique	properNoun
Hoxhaj	Hoxhaj	properNoun
Matejce	Matejce	properNoun
Duraskovic	Duraskovic	properNoun
Grahovac	Grahovac	properNoun
Mikac	Mikac	properNoun
Zef	Zef	properNoun
Vedrine	Vodrine	properNoun
Heco	Heco	properNoun
Kalinin	Kalinin	properNoun
Sarospatak	Sarospatak	properNoun
Manolopoulou	Manolopoulou	properNoun
Cvetin	Cvetin	properNoun
Kotor	Kotor	properNoun
Batsheva	Batsheva	properNoun
Davut	Davut	properNoun
Mainel	Mainel	properNoun
Montenegrobank	Monténégobank	properNoun
Kelesoglu	Kelesoglu	properNoun
Gorkou	Gorkou	properNoun
Ikonjo	Ikonjo	properNoun
Belek	Belek	properNoun
Sofer	Sofer	properNoun
Sabrije	Sabrije	properNoun
Kone	Kone	properNoun
Kocevski	Kocevski	properNoun
Papadimitropoulos	Papadimitropoulos	properNoun
Globul	Globul	properNoun
Ridge	la crête	noun
Ridge	l' arête	noun
Ridge	le faîte	noun
Ridge	la chaîne	noun
Ridge	la corniche	noun
Ridge	le récif	noun
Ridge	billonner	verb
Ridge	strier	verb
Ridge	crête	None
Maxhun	Maxhun	properNoun
Dtt	Dtt	properNoun
Ilias	Ilias	properNoun
Padron	Padon	properNoun
Švarc	Švarc	properNoun
Androulla	Androulla	properNoun
Capoglu	Capoglu	properNoun
Fitim	Injuste	properNoun
Irenej	Irenej	properNoun
Mehmeti	Mehmeti	properNoun
Trivic	Trivitique	properNoun
Herculane	Herculade	properNoun
Nazarian	Nazarian	properNoun
Wenders	Grogner	properNoun
Muris	Muris	properNoun
Hajdini	Hajdini	properNoun
Crkvice	Crkvice	properNoun
Dalis	Dalis	properNoun
Pavlina	Pavlina	properNoun
Bjeshket	Bêtises	properNoun
Durao	Durao	properNoun
Kondovo	Kondovo	properNoun
Kokallanov	Kokallanov	properNoun
Kahlo	Kahlo	properNoun
Falticeni	Falticeni	properNoun
Krepieva	Krepiva	properNoun
Dobroste	Dobroste	properNoun
Stoddart	Stoddart	properNoun
Kuprianov	Kuprianov	properNoun
Prijedor	Priodedor	properNoun
Stano	Stantan	properNoun
Deliu	Délice	properNoun
Radojka	Radojka	properNoun
Atocha	Atocha	properNoun
Idriz	Iriz	properNoun
Ozen	Ozen	properNoun
Culi	Cul	properNoun
Najdovska	Najdovska	properNoun
Vogosca	Vogosca	properNoun
Konispol	Konispol	properNoun
Mjak	Mjak	properNoun
Bojaxhi	Bojaxhi	properNoun
Bradis	Bradis	properNoun
Nduke	Nduke	properNoun
Barice	Barre	properNoun
Melek	Melek	properNoun
Radoje	Radoje	properNoun
Pancic	Panconique	properNoun
Kardon	Kardon	properNoun
Kumbul	Kumbul	properNoun
Trigono	Trigono	properNoun
Erksan	Tanksan	properNoun
Enersys	Enerersys	properNoun
Halime	Halime	properNoun
Vatopedi	Vatopedi	properNoun
Puaca	Puaca	properNoun
Stasa	Stasa	properNoun
Cismigiu	Cismigiu	properNoun
Daticum	Dictionnaire	properNoun
Abdulmutallip	Abdulmutallip	properNoun
Savnik	Savnik	properNoun
Gouliaris	Gouliaris	properNoun
Tango	le tango	noun
Tango	danser le tango	verb
Tango	Tango	None
Kravljanac	Kravljanac	properNoun
Retezat	Reézat	properNoun
Runjanin	Runjanin	properNoun
Wojtyla	Wojtyla	properNoun
Dvorovi	Dvorovi	properNoun
Malenko	Malenko	properNoun
Platformu	Plate-forme	properNoun
Daiane	Daiane	properNoun
Farmakis	Fermier	properNoun
Milickovic	Milickovic	properNoun
Shugurov	Shuguov	properNoun
Sofronievska	Sofronievska	properNoun
Lefkimi	Lefkimi	properNoun
Plava	Plava	properNoun
Sijan	Sijan	properNoun
Ambalaj	Ambalaj	properNoun
Puzigaca	Puzigaca	properNoun
Dooman	Dooman	properNoun
Hanganu	Hanganu	properNoun
Birra	Birra	properNoun
Elkind	Élan	properNoun
Mallias	Mallias	properNoun
Intracom	Intracom	properNoun
Maries	Marie	properNoun
Crisan	Crisan	properNoun
Tudorache	Tudorache	properNoun
Klico	Klico	properNoun
Ozkirimli	Ozkirimli	properNoun
Lanzarote	Lanzarote	properNoun
Marikaj	Marikaj	properNoun
Anatolian	Anatolien	properNoun
Ndrea	NDREA	properNoun
Crocker	Cocotte	properNoun
Budisavljevic	Budisavljevic	properNoun
Karponosov	Karponosov	properNoun
Atromitos	Atromitos	properNoun
Mukhrani	Mukhrani	properNoun
Rikom	Rikom	properNoun
Dromader	Dromader	properNoun
Bossey	Bossey	properNoun
Gaitanos	Gouttes	properNoun
Sarilar	Sarila	properNoun
Kukuriku	Kukuriku	properNoun
Anzac	Anzac	properNoun
Ragip	Ragip	properNoun
Marelli	Marelli	properNoun
Limantepe	Limanepe	properNoun
Cola	la cola	noun
Cola	Cola	None
Maro	Maro	properNoun
Buick	Buick	properNoun
Ornette	Ornette	properNoun
Bezi	Bezi	properNoun
Ena	Énoncé	properNoun
Maoca	Maoca	properNoun
Razanica	Razanica	properNoun
Varda	Varda	properNoun
Oguz	Oguz	properNoun
Taqaddum	Taqaddum	properNoun
Merkoci	Merkoci	properNoun
Milia	Milia	properNoun
Marsha	Marsha	properNoun
Eekelen	Eekelen	properNoun
Tezdjan	Tezdjan	properNoun
Ninanajna	Ninanajna	properNoun
Staden	Faire des stades	properNoun
Shafak	Shafak	properNoun
Saryari	Shayari	properNoun
Reznik	Reznik	properNoun
Petrusheva	Arthreva	properNoun
Balaz	Ballaz	properNoun
Katon	Katon	properNoun
Gergov	Gergov	properNoun
Doliche	Doliche	properNoun
Aydogan	Aydogan	properNoun
Legende	Légende	properNoun
Milovac	Milovac	properNoun
Siderov	Siderov	properNoun
Troicki	Troiki	properNoun
Gudjufi	Gudjufi	properNoun
Gamzigrad	Gamzigrad	properNoun
Pazova	Pazova	properNoun
Kornati	Kornati	properNoun
Tocci	Tocci	properNoun
Frist	Franc	properNoun
Otosan	Otosan	properNoun
Vrdoljak	Vrdoljak	properNoun
Shirwan	Shirwan	properNoun
Gonzi	Gonzi	properNoun
Doina	Dotina	properNoun
Amza	Amza	properNoun
Nexhipi	Nexhipi	properNoun
Abdulakim	Abdulakim	properNoun
Mimmo	Mimmo	properNoun
Gassra	Gassra	properNoun
Pervathi	Pervathi	properNoun
Namik	Namik	properNoun
Monistiraki	Monastiraki	properNoun
Poyraz	Poyraz	properNoun
Bonomy	BONOMIE	properNoun
Kapsali	Kapsali	properNoun
Aboul	Aboul	properNoun
Zorica	Zorica	properNoun
Covaliu	Covaliu	properNoun
Eirene	Eirene	properNoun
Stavridis	Stavridis	properNoun
Fahmy	Fahomme	properNoun
Shkurte	Shkurte	properNoun
Ahd	Ahd	properNoun
Reiko	Reiko	properNoun
Mateescu	Matecucu	properNoun
Ejmen	Ejmen	properNoun
Nazmi	Nazmi	properNoun
Spasulati	Spasulati	properNoun
Evgeni	Evgeni	properNoun
Maud de Boer-Buquicchio	Maud de Boer-Buquicchio	properNoun
Stoinescu	Stoinescu	properNoun
Gorge	la gorge	noun
Gorge	le passage	noun
Gorge	le gosier	noun
Gorge	le ventre	noun
Gorge	engouffrer	verb
Gorge	se rassasier	verb
Gorge	Gorge	None
Ivchenko	Ivchenko	properNoun
Vitina	Vitain	properNoun
Hoca	Hoca	properNoun
Flack	Flack	properNoun
Slovenske	Slovenske	properNoun
Karpat	Karpat	properNoun
Mutlu	Mutlu	properNoun
Sipocki	Sipocki	properNoun
Sitel	Satel	properNoun
Abdulkadir	Abdulkadir	properNoun
Liviu	Liviu	properNoun
Kikis	Kikis	properNoun
Avsar	Avsar	properNoun
Bebe	Bebe	properNoun
Nepochatih	Nepochatih	properNoun
Gvero	Gavero	properNoun
Kosanovic	Kosanovic	properNoun
Akbar	Akbar	properNoun
Rosneft	Rosneft	properNoun
Westerwelle	Westerwelle	properNoun
Arunas	Arunas	properNoun
Bühler	Bühler	properNoun
Smail	Smail	properNoun
Haskuka	Haskuka	properNoun
Brahimi	Brahimi	properNoun
Kepez	Kepez	properNoun
RomTelecom	Romtelecom	properNoun
Kesetovic	Kesetovic	properNoun
Kovaceva	Kovaceva	properNoun
Baquba	Baquba	properNoun
Berdymukhammedov	Berdymukhammedov	properNoun
Miftari	Miftari	properNoun
Planetak	Planettak	properNoun
Caparde	CABARDE	properNoun
Lipitkova	Lipitkova	properNoun
Nurcan	Nucain	properNoun
Strachota	Strachota	properNoun
Natura	Natura	properNoun
Thaksin	Thaksin	properNoun
Hamdi	Hamdi	properNoun
Mergea	Merde	properNoun
Inova	Inova	properNoun
Idadija	Idadija	properNoun
Bishari	Bishais	properNoun
Soner	Soneur	properNoun
high time	grand temps	properNoun
Garros	Garros	properNoun
Kurdzhali	Kurdzhali	properNoun
Kushtrim	Kushtrim	properNoun
Ispat	Ispat	properNoun
Vasilescu	Vasilecucu	properNoun
Teodorescu	Teodorescu	properNoun
Tomislavgrad	Tomislavgrad	properNoun
Ambelokipi	Ambelokipi	properNoun
Ymittos	Ymittos	properNoun
Bevilaqua	Bevilaqua	properNoun
Mileva	Mileva	properNoun
Gloviczky	Gloviczky	properNoun
Vehapi	Véhicules	properNoun
Drzen	Drzen	properNoun
Podobnik	Podobnik	properNoun
Likomanov	Lifomanov	properNoun
Aliaj	Aliaj	properNoun
Ruza	Ruza	properNoun
Nagano	Nagano	properNoun
Republike	République	properNoun
Codrut	CODRUT	properNoun
Sampras	Sampras	properNoun
Codrea	CODREA	properNoun
Kavaja	Kavaja	properNoun
Bartumeu	Bartume	properNoun
Hammarberg	Hammarberg	properNoun
Struma	Struma	properNoun
Metron	Métrons	properNoun
Sahlin	Sahlin	properNoun
Cagrici	Cagrici	properNoun
Sabahattin	Sabahattin	properNoun
Radeva	Radeva	properNoun
Palazzo	Palais	properNoun
Artfilm	Artfilm	properNoun
Qadi	Qadi	properNoun
Cubukcu	Cubukcu	properNoun
Sulduba	Sulduba	properNoun
Kasapderesi	Kasapderesi	properNoun
Oosterdam	Oosterdam	properNoun
Spasijka	Spasijka	properNoun
Tepe	Teepe	properNoun
Aare	Aare	properNoun
Bozkus	Bozkus	properNoun
Strbac	Strabisme	properNoun
Oplenac	Oplenac	properNoun
Blecic	Blecique	properNoun
Belushi	Belushi	properNoun
Tareq	Taréq	properNoun
Nestle	se nicher	verb
Nestle	abriter	verb
Nestle	se pelotonner	verb
Nestle	Se nicher	None
Marjanac	Marjanac	properNoun
Tataragic	Tatargique	properNoun
Demirdag	Dossier	properNoun
Chomolungma	Chomolungma	properNoun
Marmaray	Marmaray	properNoun
Smokvica	Smokvica	properNoun
Kerron	Kerron	properNoun
Bandur	Bandoulière	properNoun
figure skating	le patinage artistique	noun
figure skating	patinage artistique	None
Papanicolaou	Papanicolaou	properNoun
Ginovska	Ginovska	properNoun
Erturgul	Ertugrul	properNoun
Imroz	Imroz	properNoun
Dizdar	Dizdar	properNoun
Celestin	Céleste	properNoun
Mejra	Mejra	properNoun
Morrell	Morceau	properNoun
Bresson	Bresson	properNoun
Modrica	Modérum	properNoun
Blackard	Blackard	properNoun
Ocasio	Ocasio	properNoun
Alakopru	Alakopru	properNoun
Overstreet	Surpasser	properNoun
Rossin	Rossin	properNoun
Bekiri	Bekiri	properNoun
Ntoskas	Ntoskas	properNoun
Kostadinovski	Kostadinovski	properNoun
Atebank	Atebank	properNoun
Koumanakou	Koumanakou	properNoun
Serafettin	Serafettin	properNoun
Lamatic	Lamentard	properNoun
Prom	le front de mer	noun
Prom	Bal de promo	None
Turcu	Turcu	properNoun
grow stronger	devenir plus fort	properNoun
Hernadi	Hernadi	properNoun
Virgiliu	Virgiliu	properNoun
Kapon	Kapon	properNoun
Željko	Željko	properNoun
Salon	le salon	noun
Salon	Salon	None
Othonas	Othonas	properNoun
Abed	couché	adverb
Abed	Un lit	None
Velmar	Velmar	properNoun
Lichtman	Lichtman	properNoun
Surinam	Surinam	properNoun
Vaser	Vaser	properNoun
Topcu	Topcu	properNoun
Vierita	Vierge	properNoun
Okey	Ça va!	interjection
Okey	Très bien!	interjection
Okey	Bien!	interjection
Okey	D'accord!	interjection
Okey	Tout marche bien!	interjection
Okey	Bien	None
Anibar	Anibar	properNoun
Riste	Ristère	properNoun
Vouyias	Vouyias	properNoun
Blagaj	Blagaj	properNoun
Vajska	Vajska	properNoun
Bolshoi	Bolshoi	properNoun
Dragusin	Dragusin	properNoun
Termoelektrana	Termoelektrana	properNoun
Urdur	Urdeur	properNoun
Halit	Halit	properNoun
Vivatel	Vivatel	properNoun
Mugla	Mugla	properNoun
Menzel	Menzil	properNoun
Uzic	Uzic	properNoun
Dragica	Dragica	properNoun
Bijakovici	Bijakovici	properNoun
Pfizer	Pfizer	properNoun
Kosaca	Kosaca	properNoun
Radimir	Radimir	properNoun
Sorcova	Sorcova	properNoun
Mazuru	Mazuru	properNoun
Milolidaki	Milolidaki	properNoun
Est	Est	properNoun
Tarot	Tarot	properNoun
Shughour	Shughour	properNoun
Kesko	Kesko	properNoun
Gofi	Gofi	properNoun
Pedja	Pedja	properNoun
Miodrag	Miodrag	properNoun
Dragisa	Dragisa	properNoun
Ticu	Ticu	properNoun
Bjornsson	Bjornsson	properNoun
Alastair	Alastair	properNoun
Sibovci	Sibovci	properNoun
Flutur	Flutur	properNoun
EuroBasket	Eurobasket	properNoun
Busovaca	Busovaca	properNoun
Lozina	Lozina	properNoun
Lehigh	Lehigh	properNoun
Erguvenc	Erguvenc	properNoun
Antoniu	Antoniu	properNoun
Stojanova	Stojanova	properNoun
Gardev	Gardev	properNoun
Palanka	Palanka	properNoun
Kokkinos	Kokkinos	properNoun
Grosomanidou	Grosomanidou	properNoun
Chatham	Chatham	properNoun
Eupolitix	Eupolitix	properNoun
Alijana	Alijana	properNoun
Poti	Poti	properNoun
Banovici	Banovici	properNoun
Akrotiri	Akrotiri	properNoun
MobilTel	Mobilel	properNoun
Parreira	Parreira	properNoun
Tokat	Tokat	properNoun
Layard	Layard	properNoun
Zlatovic	Zlatovic	properNoun
in a row	en rang	adverb
in a row	dans une rangée	None
Nagorno	Nagorno	properNoun
Kastamonu	Kastamonu	properNoun
Candan	Candan	properNoun
Islaz	Islaz	properNoun
Leonov	Léonov	properNoun
Malmo	Malmo	properNoun
Vaigel	Vaigel	properNoun
Morjane	Morjane	properNoun
Brodilovo	Brodilovo	properNoun
Vracar	Vracar	properNoun
Lekythos	Lekythos	properNoun
finish saying	finir	properNoun
Soeder	Fusion	properNoun
Atanasova	Atanasova	properNoun
Rogaya	Rogaya	properNoun
Stojku	Stojku	properNoun
Suveyda	Suveyda	properNoun
Radoslav	Radoslav	properNoun
Kyodo	Kyodo	properNoun
Durer	Durer	properNoun
Erener	Erener	properNoun
Kosgar	Kosgar	properNoun
Staicu	Staicu	properNoun
Albrecht	Albrecht	properNoun
Socaciu	Socaciu	properNoun
Secunovic	Secunovic	properNoun
Beqo	Beqo	properNoun
Rajamaki	Rajamaki	properNoun
Milovan	Milovan	properNoun
Spanou	Spanou	properNoun
Lura	Lura	properNoun
Mugur	Mugur	properNoun
Ugljesa	Ugljesa	properNoun
Hrebickova	Hrebickicka	properNoun
Azra	Azra	properNoun
Srbinje	Srbinje	properNoun
Movil	Movil	properNoun
Kume	Kume	properNoun
Girne	Giron	properNoun
Eleutherna	Eleutherna	properNoun
Kondopoulos	Kondopoulos	properNoun
Sumru	Sugnru	properNoun
Krs	KRS	properNoun
Colonna	Colonna	properNoun
Ajdini	Ajdini	properNoun
Fazil	Fazil	properNoun
Annabi	Annabi	properNoun
Ibush	Ibush	properNoun
Durontine	Durontine	properNoun
Brailovo	Brailovo	properNoun
Theodhoro	Théodhoro	properNoun
Valjevo	Valjevo	properNoun
Tenet	le principe	noun
Tenet	la doctrine	noun
Tenet	le dogme	noun
Tenet	Principe	None
Skatche	Skaqueté	properNoun
Pazin	Pazin	properNoun
Kvadra	Kvadra	properNoun
Mucaj	Mucaj	properNoun
Itebej	Itbej	properNoun
Gostovic	Gostovic	properNoun
Avgi	Avgi	properNoun
Bos	Bos	properNoun
Infotech	Infotech	properNoun
Felaj	Felaj	properNoun
Cvjetan	CVJETAN	properNoun
Elezi	Elezi	properNoun
Hond	Hond	properNoun
Viking	le viking	noun
Viking	Viking	None
Marinel	Marinel	properNoun
Filat	Filat	properNoun
Lakcevic	Lakcevic	properNoun
Blushi	Blushi	properNoun
Machu	Machu	properNoun
Gregos	Grégos	properNoun
Miglena	Miglena	properNoun
Alcatel	Alcatel	properNoun
Cumpanasu	Cumanasu	properNoun
Akgun	Akgun	properNoun
Dassos	Dassos	properNoun
Ulker	Ulker	properNoun
Monaf	Monaf	properNoun
Dafova	Dafova	properNoun
Louizos	Louizos	properNoun
Astaldi	Astaldi	properNoun
Meer	Métier	properNoun
Haidinger	Haidinger	properNoun
Muminovic	Muminovic	properNoun
Casella	Casellerie	properNoun
Maronite	Maronite	properNoun
Carraluge	Carraluge	properNoun
Gaprindashvili	Gaprindashvili	properNoun
Krusha	Krusha	properNoun
Kostajnica	Kostajnica	properNoun
Siladji	Siladji	properNoun
Kirkorov	Kirkorov	properNoun
Sophos	Sophos	properNoun
Pocrnja	Pocrnja	properNoun
Kayhan	Kayhan	properNoun
Herder	Berger	properNoun
Hannes	Hanne	properNoun
Gillette	Gillette	properNoun
Majic	Majique	properNoun
Kanga	Kanga	properNoun
Haziri	Haziri	properNoun
Mandi	Mandi	properNoun
Vojordanie	Vojordanie	properNoun
Petrika	Petrika	properNoun
Faustmann	Faustmann	properNoun
Rakan	Rakan	properNoun
Karadjordjevic	Karadjordjevic	properNoun
Artemije	Artemije	properNoun
Rangelova	Rangelova	properNoun
Radoborska	Radoborska	properNoun
Saeb	Saeb	properNoun
Zetas	Zétas	properNoun
Hursit	Faucher	properNoun
Suna	Suna	properNoun
Staykov	Staykov	properNoun
Thanos	Thanos	properNoun
Mintas	Multes	properNoun
Philippi	Philippin	properNoun
Vego	Veine	properNoun
Ratkovic	Ratkovic	properNoun
Verhagen	Verhagène	properNoun
Rusmali	Rusmali	properNoun
Huawei	Huawei	properNoun
Haekkerup	Haekkerup	properNoun
Cristea	Cristea	properNoun
Donati	Donati	properNoun
Zogjani	Zogjani	properNoun
Christoulas	Christoulas	properNoun
Reducu	Réducteur	properNoun
Mravak	Myrvak	properNoun
Dyulgerov	Dyulgerov	properNoun
Barend	Barendre	properNoun
Spasovdan	Spasovdan	properNoun
Bikovo	Bikovo	properNoun
Santacaterina	Santacaterina	properNoun
Shivanidze	Shivanidze	properNoun
Kikia	Kikia	properNoun
Svrakic	Svrakic	properNoun
Karray	Karray	properNoun
Makavejev	Makavejev	properNoun
Apollonia	Apollonia	properNoun
Matev	Matev	properNoun
Jeleva	Jeleva	properNoun
Peristeri	Peristeri	properNoun
Sarris	Sarris	properNoun
Hoagiu	Hoagiu	properNoun
Pulaj	Pulaj	properNoun
Saryusz	Saryusz	properNoun
Olovo	Olovo	properNoun
Duta	DUTA	properNoun
Helvacioglu	Helvacioglu	properNoun
Konstantinov	Konstantinov	properNoun
Nenezic	Nénézique	properNoun
Dogubeyazit	Dogubeyazit	properNoun
Cristinel	Cristinelle	properNoun
Pompidou	Pompidou	properNoun
Debalde	Débalde	properNoun
Kusovac	Kusovac	properNoun
Bezusaja	Bezusaja	properNoun
Mahir	Mahir	properNoun
Eyjafjallajokull	Eyjafjallajokull	properNoun
Podravka	Podravka	properNoun
Damme	Damer	properNoun
Lompar	Lombalier	properNoun
Konya	Kongea	properNoun
Garvin	Garvin	properNoun
Colakoglu	Colakoglu	properNoun
Kinderdorf	Gentildorf	properNoun
Noureini	Noueini	properNoun
Adomnitei	Adomnitei	properNoun
Usak	Usak	properNoun
Pharos	Pharos	properNoun
Sabazia	Sabazie	properNoun
Eco	Éco	properNoun
Babka	Babka	properNoun
Helmut	Halètement	properNoun
Ideea	Idea	properNoun
Nouriel	Nouriel	properNoun
Vranes	Vranes	properNoun
Giddens	Giddènes	properNoun
Ekmen	Ekmen	properNoun
Carras	Carras	properNoun
Genceli	Genceli	properNoun
Meskov	Meskov	properNoun
Briag	Briag	properNoun
Prunariu	Prunariu	properNoun
Blerina	Blérina	properNoun
Magi	Magi	properNoun
Mirka	Mirka	properNoun
Veizi	Veizi	properNoun
Ehli	Ehli	properNoun
Daynov	Daynov	properNoun
Cenacolo	Cenacolo	properNoun
Zymberaj	Zymberaj	properNoun
Meng	Meng	properNoun
Dolezal	Dolézal	properNoun
Kayaturk	Kayaturk	properNoun
Lucin	Lucin	properNoun
Medicus	Médecin	properNoun
Cesarini	Cesarini	properNoun
Ceylanoglu	Ceylanoglu	properNoun
Vasovski	Vasovski	properNoun
Singidunum	Singidunum	properNoun
Cassander	Cassander	properNoun
Tirlea	Tellea	properNoun
Karpas	Karpas	properNoun
Zalmay	Zalmay	properNoun
Cubismo	Cubismo	properNoun
Hanrahan	Hanrahan	properNoun
Donassy	Donassy	properNoun
Viswanathan	Viswanathan	properNoun
Moscopole	Moscopole	properNoun
Kalashnikovs	Kalachnikovs	properNoun
Demirovska	Demirovska	properNoun
Vule	Vule	properNoun
Cretu	Crétu	properNoun
Alban	Alban	properNoun
Nedelkova	Nedelkova	properNoun
Kosak	Kosak	properNoun
Icevska	Icevska	properNoun
Tekelioglu	Tekelioglu	properNoun
Betanews	Betanews	properNoun
Diyarbakır	Diyarbakır	properNoun
Somun	Somundi	properNoun
Pheidias	Phénidias	properNoun
Sighetu	SighTeu	properNoun
Diber	Digue	properNoun
Kokkalakis	Kokkalakis	properNoun
Majd	Maj	properNoun
Paruk	Paruk	properNoun
Morss	Mors	properNoun
Seling	Puissant	properNoun
Gorur	Gorgin	properNoun
Aharonovitz	Aharonovitz	properNoun
Tatlican	Tatlican	properNoun
Spyridos	Spyridos	properNoun
Sanomat	Sanomat	properNoun
Zilha	Zilha	properNoun
Sabovic	Sabovic	properNoun
Rui	Rui	properNoun
Musovica	Musovica	properNoun
Nini	Ninié	properNoun
Aktay	Aktay	properNoun
Fechete	Fécherie	properNoun
Kjartan	Kjartan	properNoun
Lobont	Lobont	properNoun
Fitou	Fidou	properNoun
Hazal	Hausse	properNoun
Kenan	Kenan	properNoun
Alumni	Anciens	properNoun
Saraquin	Saraquin	properNoun
Andreea	Andrea	properNoun
Saygun	Dictionnaire	properNoun
Gazafer	Gaspilleur	properNoun
Miladinovic	Miladinovic	properNoun
Depeche	Dépeche	properNoun
Rijecka	Rijecka	properNoun
Nurja	Nurja	properNoun
round up	rassembler	verb
round up	réunir	verb
round up	rassembler	None
Schwarzenberg	Schwarzenberg	properNoun
Lazarovska	Lazarovska	properNoun
Mahalla	Mahalla	properNoun
Malaj	Malaj	properNoun
Zaharopoulos	Zaharopoulos	properNoun
Stroicki	Stroicki	properNoun
Dhori	Dhori	properNoun
Paroushev	Paroushev	properNoun
Concolato	Concolato	properNoun
Leben	Leben	properNoun
Galichica	Galichica	properNoun
Trava	Travail	properNoun
Cernit	Cernit	properNoun
Que	Que	properNoun
Rizahau	Rizahau	properNoun
Kraounakis	Kraounakis	properNoun
Tanir	Tanir	properNoun
Mejias	Mejias	properNoun
Svensson	Svensson	properNoun
Klimeski	Klimeski	properNoun
five-year	les quinquennal	noun
five-year	cinq ans	None
Selimi	Selimi	properNoun
Alush	Aluniment	properNoun
Hirschhofer	Hirschhofer	properNoun
Chiarini	Chiarini	properNoun
Bem	Bem	properNoun
Kozarac	Kozarac	properNoun
Ratzel	Ratzel	properNoun
Srbobran	Srbobran	properNoun
Karapandzevski	Karapandzevski	properNoun
Vistonitis	Victiquée	properNoun
Badiu	Badiu	properNoun
Weafer	Gainant	properNoun
Panton	Panton	properNoun
Petrom	Pétromier	properNoun
Daniilidou	Daniilidou	properNoun
Mura	Mura	properNoun
Baljak	Ballaque	properNoun
Pierrick	Pierrick	properNoun
Vista	la vue	noun
Vista	la perspective	noun
Vista	l' horizon	noun
Vista	les point de vue	noun
Vista	Vue	None
Ciller	Ciller	properNoun
Dias	Dias	properNoun
Zachau	Zachau	properNoun
Kaita	Kaita	properNoun
Momcjil	Momcjil	properNoun
Benoit	Benoit	properNoun
Lockheed	Lockheed	properNoun
Aleksic	Aleksic	properNoun
Piccadilly	Piccadilly	properNoun
Lennmarker	Lennmarker	properNoun
Haggadah	Haggadah	properNoun
Spinderlegger	Spinderlegger	properNoun
Sagrada	Sagrada	properNoun
Andreev	Andreev	properNoun
Metin	Métine	properNoun
Silkenath	Silkène	properNoun
Lilan	Lilan	properNoun
Symi	Symi	properNoun
Tepelena	Tepelena	properNoun
Zeyneddin	Zeyneddin	properNoun
Bozoljac	Bozoljac	properNoun
Sloga	Sloga	properNoun
Guccione	Guccione	properNoun
Ilke	Ilke	properNoun
Pilic	Pilique	properNoun
Femen	Femme	properNoun
Poni	Poni	properNoun
Sevil	Se sévir	properNoun
Sihana	Sihana	properNoun
Styliani	Styliani	properNoun
C	C	properNoun
Badivuku	Badivuku	properNoun
Dobrovoljacka	Dobrovoljacka	properNoun
Knop	Cerveau	properNoun
Rudic	Rudic	properNoun
Varoe	Voile	properNoun
Kustrinovic	Kustrinovic	properNoun
Antic	la cabriole	noun
Antic	la bouffonnerie	noun
Antic	la gambade	noun
Antic	le comportement étrange	noun
Antic	Antique	None
Bonyo	Bonyo	properNoun
Ubavska	Ubavska	properNoun
Economou	Économou	properNoun
Cavafy	Cavafy	properNoun
Kurdjali	Kurdjali	properNoun
Syrin	Syrine	properNoun
Hamptons	Hampons	properNoun
Turculet	Turculette	properNoun
Sjenica	Sjenica	properNoun
Kasper	Kasper	properNoun
Vrbovac	Vrbovac	properNoun
Ugljevik	Ugljevik	properNoun
Gebze	Gebze	properNoun
Westerman	Westerman	properNoun
Mirel	Miroule	properNoun
Miho	Miho	properNoun
Libertatu	Libertaatu	properNoun
Dudko	Dudko	properNoun
Spanopoulos	Spanopoulos	properNoun
Kaludi	Kaludi	properNoun
Fulga	Fulga	properNoun
Molla	Molla	properNoun
Beldiman	Beldiman	properNoun
Sarande	Sarande	properNoun
Gowing	Gousse	properNoun
Milen	Militaire	properNoun
Kristensson	Kristensson	properNoun
Gaon	Gaon	properNoun
Logolu	Logolu	properNoun
Slavenko	Slavenko	properNoun
Zvonimir	Zvonimir	properNoun
Čeku	Čeku	properNoun
Financiar	Financier	properNoun
Vozuca	Vozuca	properNoun
Fotini	Fotini	properNoun
Hipotekarna	Hipotekarna	properNoun
Anguilara	Anguillara	properNoun
Andreadis	Andreadis	properNoun
Usackas	Usackas	properNoun
Radical	radical	adjective
Radical	le radical	noun
Radical	Radical	None
Avangarde	Avangarde	properNoun
Muk	Muqueux	properNoun
Vojce	Vocale	properNoun
Dragun	Dragun	properNoun
Osmanaj	Osmanaj	properNoun
Derici	Derici	properNoun
Liridon	Liridon	properNoun
Seleskovi	Seleskovi	properNoun
Adriatik	Adriatik	properNoun
Isler	Isler	properNoun
Witold	Gigantesque	properNoun
Arianit	Arianit	properNoun
Spyropoulou	Spyropoulou	properNoun
Abidine	Abdominal	properNoun
Vuckovi	Vuckovi	properNoun
Bijelo	Bijelo	properNoun
Merkur	Merkur	properNoun
Boljevci	Boljevci	properNoun
Struga	Struga	properNoun
Hanelli	Hanelli	properNoun
Chatterton	Chatter	properNoun
Bwin	Bwin	properNoun
Bajac	Bajac	properNoun
Zaldiva	Zaldiva	properNoun
Vremir	Vremir	properNoun
Partisi	Partitisi	properNoun
Malamis	Malchanceux	properNoun
Avni	Avni	properNoun
Busek	Busek	properNoun
Tsitouridis	Tsitouridis	properNoun
Lossmann	Lossann	properNoun
Abaspahic	Abasimporte	properNoun
Veraas	Veraas	properNoun
Kutlesa	Kutlesa	properNoun
Ratklif	Ratklif	properNoun
Matterhorn	Cabinet	properNoun
Sagir	Sagir	properNoun
Bulgartabac	Boulgartabac	properNoun
Gojanovi	Gojanovi	properNoun
Cilingiroglu	Cilingiroglu	properNoun
Omolios	Omolios	properNoun
Prvce	Prouver	properNoun
Topaz	la topaze	noun
Topaz	Topaze	None
Chelyabinsk	Chélybinsk	properNoun
Lazard	Lazard	properNoun
Kiziltan	Kiziltan	properNoun
Ahmetxhekaj	Ahmetxhekaj	properNoun
Wuest	Wuest	properNoun
Metodi	Métori	properNoun
Klemencic	Klemencique	properNoun
Balaban	Balaban	properNoun
Koce	Koce	properNoun
Andreevo	Andreevo	properNoun
Galicka	Galère	properNoun
Baneasa	Banase	properNoun
Berc	Berc	properNoun
Pedion	Pédaler	properNoun
Sandulescu	Sandulescu	properNoun
Herbie	Herbie	properNoun
Neven	Nevère	properNoun
RoImage	Routre	properNoun
Besa	Besa	properNoun
Kucukandonyadis	Kucukandonyadis	properNoun
Burbuqe	Burbuqe	properNoun
Lalenkov	Lalenkov	properNoun
Kleminec	Kleminec	properNoun
Hayatoglu	Hayatoglu	properNoun
Selic	Selic	properNoun
Fuat	Fuat	properNoun
Almhofer	Almhofer	properNoun
Azeski	Azeski	properNoun
Dogg	Dogg	properNoun
Bosanac	Bosanac	properNoun
Fišer	Fidélité	properNoun
Shadrevan	Shadrevan	properNoun
Shabalin	Shabalin	properNoun
Pascariu	Pascariu	properNoun
Koshi	Koshi	properNoun
Mithraic	Mithraique	properNoun
Belkeziz	Belkeziz	properNoun
Dolovac	Dolovac	properNoun
Kirszner	Kirszner	properNoun
Nalbant	Nalbant	properNoun
Nevestino	Névestino	properNoun
Dinosa	le dinosaure	noun
Dinosa	Dinosaure	None
Petrus	Petrus	properNoun
Ozgurgun	Ozgurgun	properNoun
Ghimpu	Ghimpu	properNoun
Lako	Lako	properNoun
Gasherbrum	Gaspilleur	properNoun
Eker	Eker	properNoun
Recber	Se comporter	properNoun
Kaariainen	Kaariainen	properNoun
Bikos	Bikos	properNoun
Ejupi	Ejupi	properNoun
Aksiopoli	AKSIOPOLI	properNoun
Fordow	Fordow	properNoun
Schiffer	Schiffer	properNoun
Ferketi	Ferketi	properNoun
Meiser	Mégère	properNoun
Gogovski	Gogovski	properNoun
Laureus	Laurier	properNoun
Oguzhan	Oguzhan	properNoun
Elenovska	Elenovska	properNoun
Roj	Roj	properNoun
Gulsun	Gulun	properNoun
Marem	Marem	properNoun
Leart	Apprendre	properNoun
Fipresci	Fipresci	properNoun
Glavatovic	Glavatovic	properNoun
Erhan	Erhan	properNoun
Svilen	Svilen	properNoun
Bobetko	Bobetko	properNoun
Stefkovski	Stefkovski	properNoun
Praxis	l' habitude	noun
Praxis	la tradition	noun
Praxis	Praxis	None
Konstandaras	Konstandaras	properNoun
Laureta	Laureta	properNoun
Gvozden	Gvozden	properNoun
Ribnica	Ribnica	properNoun
Cesic	Césique	properNoun
Calvi	Calvien	properNoun
Microcosmos	Microcosmos	properNoun
Berishaj	Berishaj	properNoun
Ozgus	Ozgus	properNoun
Patos	Patos	properNoun
Deshira	Deshira	properNoun
Megara	Mégare	properNoun
Marvinci	Marvinci	properNoun
Kuveyt	Kuveyt	properNoun
Gulbis	Gulbis	properNoun
Egemen	Église	properNoun
Xezal	Xezal	properNoun
flesh	la chair	noun
flesh	la peau	noun
flesh	la graisse	noun
flesh	retourner	verb
flesh	inciter	verb
flesh	la chair	None
Knezevic	Knezevic	properNoun
Findikli	Findikli	properNoun
Kackar	Kackar	properNoun
Rosoman	Rosoman	properNoun
Esbjorn	Esbjorn	properNoun
Benaki	Benaki	properNoun
Dalipi	Dalipi	properNoun
Minuto	Minuto	properNoun
Zejmen	Zejmen	properNoun
Halabja	Halaabja	properNoun
Pindos	Pindos	properNoun
Ilire	ILire	properNoun
Glori	Glori	properNoun
Softlab	Softlab	properNoun
Torbatov	Torbatov	properNoun
Dudu	Degré	properNoun
Tropoje	Tropoje	properNoun
Maral	Maral	properNoun
Stambuk	Stambuk	properNoun
Sub	Sous	properNoun
Gasstroymontaj	Gasstroymontaj	properNoun
Nibens	Nibier	properNoun
Brigel	Brigel	properNoun
Campos	Campos	properNoun
Zuzana	Zuzana	properNoun
Kandahar	Kandahar	properNoun
Harlan	Harlan	properNoun
Paabo	Paabo	properNoun
Sarejevo	Sarajevo	properNoun
Kronberger	Kronberger	properNoun
Tutenk	Tunenk	properNoun
Vlassis	Vlassis	properNoun
Aco	Aco	properNoun
Muje	Muje	properNoun
Mufail	Mufail	properNoun
Gog	Gogue	properNoun
Petrovac	Pétrovac	properNoun
Aggelos	Aggloméré	properNoun
Mizumoto	Mizumoto	properNoun
Gloser	Gloteur	properNoun
Laniste	Laniste	properNoun
Douvalidis	Douvalidis	properNoun
Mirashi	Mirashi	properNoun
Rajkova	Rajkova	properNoun
Apreotesei	Apréoesei	properNoun
Welt	la trépointe	noun
Welt	la bordure	noun
Welt	la zébrure	noun
Welt	la marque de coup	noun
Welt	papule	None
Steliana	Steliana	properNoun
Gumus	Gamus	properNoun
Dubravko	Dubravko	properNoun
Hacettepe	Hacettepe	properNoun
Blatmann	Blatmann	properNoun
Sekova	Sekova	properNoun
Feim	Feim	properNoun
Znidar	Znidar	properNoun
Kassinis	Kassinis	properNoun
Delhaize	Délhaize	properNoun
Strasho	Strasho	properNoun
Vrbas	Vrbas	properNoun
Valeri	Valérique	properNoun
Dedo	Dédicace	properNoun
Denio	Denio	properNoun
Meriç	Meriç	properNoun
Tembi	Tembi	properNoun
Savatijevic	Savatijevic	properNoun
middle east	le Moyen Orient	noun
middle east	Moyen-Orient	None
Bleeckere	Bleeckere	properNoun
Pirot	Pirot	properNoun
Andrus	Andrus	properNoun
Knezje	Knezje	properNoun
Tiryns	Tiryns	properNoun
Nanut	Nanouple	properNoun
Scout	le scout	noun
Scout	l' éclaireur	noun
Scout	la reconnaissance	noun
Scout	domestique	noun
Scout	l' avion de reconnaissance	noun
Scout	le jeune homme	noun
Scout	le type	noun
Scout	aller en reconnaissance	verb
Scout	Scout	None
Grebo	Grebo	properNoun
Nikitiadis	Nikitiadis	properNoun
Bresan	Bresan	properNoun
Vino	Vino	properNoun
Chimaroza	Chimaroza	properNoun
Grcev	Gréville	properNoun
Fratila	Fraîcheur	properNoun
the way	le chemin	properNoun
Mozer	Moeur	properNoun
Locarno	Locarno	properNoun
Busatti	Busatti	properNoun
Hildegard	Hildegard	properNoun
Tentes	Tente	properNoun
Mater	Mater	properNoun
Salvano	Salvano	properNoun
Kaneo	Kaneo	properNoun
Kyriakides	Kyriakides	properNoun
Labus	Labus	properNoun
Radmirovic	Radmirovic	properNoun
Kamynin	Kamynin	properNoun
Akyildiz	Akililiz	properNoun
Cosmaciuc	Cosmaciuc	properNoun
Sarac	Sarac	properNoun
Senol	Sien	properNoun
Syntagi	Syntagie	properNoun
Pretis	Pretis	properNoun
Puopovac	Puopovac	properNoun
Stinger	Stinger	properNoun
Arikan	Arikan	properNoun
Guenter	Guentre	properNoun
Kalajdjiev	Kalajdziev	properNoun
Stolnici	Stolnici	properNoun
Caffi	Café	properNoun
Krizancevo	Krizancevo	properNoun
Sirbegovic	Sirbegovic	properNoun
Bojinovski	Bojinovski	properNoun
Berberovic	Berberovic	properNoun
Mrakovica	Mrakovica	properNoun
Serry	Séreux	properNoun
Atrez	Atrez	properNoun
Dekon	le démon	noun
Dekon	le diable	noun
Dekon	le satin	noun
Dekon	le demi-dieu	noun
Dekon	Démon	None
Katsouranis	Katsouranis	properNoun
Ellemann	Ellemann	properNoun
Kimya	Kimya	properNoun
Ugwuh	Ugwuh	properNoun
Nursel	Pépinière	properNoun
Sabaheta	Sabahétae	properNoun
Maktouf	Maktouf	properNoun
Kuzniar	Kuzniar	properNoun
Onder	Inverse	properNoun
Nedeska	Nedeska	properNoun
Kostadinov	Kostadinov	properNoun
Cobel	Cobel	properNoun
Smederevo	SMEDEREVO	properNoun
Misini	Malini	properNoun
Matkap	Takap	properNoun
Ravi	Ravi	properNoun
Croitoru	Croire	properNoun
Aspasia	Aspasie	properNoun
Zatlers	Zatlers	properNoun
Fountoulis	Fontaine	properNoun
Namah	Namah	properNoun
Beko	Beko	properNoun
Ratnasiri	Ratnasiri	properNoun
Dundar	Dundar	properNoun
Henniya	Henniya	properNoun
Mercator	Mercator	properNoun
Scholz	Scholz	properNoun
Raffi	Raffi	properNoun
Wichter	Wichter	properNoun
Paschalides	Paschalides	properNoun
Vaskakas	Vaskakas	properNoun
Awra	Awra	properNoun
Golem	Golem	properNoun
Asty	Petite astuche	properNoun
Otri	OTRI	properNoun
Heraklea	Heraklea	properNoun
Manisa	Manie	properNoun
Vutova	Vutova	properNoun
Theodoros	Theodoros	properNoun
Steaua	Steaua	properNoun
Crnchevic	Crnchevic	properNoun
Monstat	Monstat	properNoun
Rasdaq	Rasdaq	properNoun
Eleftheros	Eleftheros	properNoun
Urbani	Urbani	properNoun
Koncul	Koncul	properNoun
Erichsen	Erichsen	properNoun
Gahan	Gahan	properNoun
Mirvete	Mirvete	properNoun
Hadzikostis	Hadzikostis	properNoun
Bosic	Bosic	properNoun
Carevic	Crevic	properNoun
Skare	Skare	properNoun
Garamhegyi	Garamhegyi	properNoun
Belenzada	Belenzada	properNoun
Zhivorad	Zhivorad	properNoun
Senechal	Sénéchal	properNoun
Lovas	Lovas	properNoun
as a result	par conséquent	properNoun
Hatzopoulos	Hatzopoulos	properNoun
Kaymak	Kaymak	properNoun
Feminnem	Féminin	properNoun
Heineken	Heineken	properNoun
Marenic	Marié	properNoun
Wunenburger	Wunenburger	properNoun
Boudel	Boudel	properNoun
Michalis	Michalis	properNoun
Kimani	Kimani	properNoun
Akkerman	Akkerman	properNoun
Kirko	Kirko	properNoun
Ceber	Creber	properNoun
Sujeong	Sujeong	properNoun
Turkian	Turkien	properNoun
Mitrea	Mitres	properNoun
Peratjkos	Pératjkos	properNoun
Megatrend	Mégatrende	properNoun
Soravia	Soravia	properNoun
Livar	Livrine	properNoun
Terazije	Terazije	properNoun
Hrvacic	Hrvacique	properNoun
Ivanko	Ivanko	properNoun
Istikbal	Istikbal	properNoun
Bajza	Bajza	properNoun
Karanfilovska	Karanfilovska	properNoun
Zepa	Zepa	properNoun
Veroljub	Veroljub	properNoun
Shabani	Shabani	properNoun
Veljan	Veljan	properNoun
Oruqi	Oruqi	properNoun
Rabih	Rabih	properNoun
Pascoe	Pascoe	properNoun
Demopoulos	Démopoules	properNoun
Ilijanco	Ilijanco	properNoun
Pasoi	Pasoi	properNoun
Kehoe	Kéhoe	properNoun
Mauresmo	Mauresmo	properNoun
Touimi	Touimi	properNoun
Sahin	Sahin	properNoun
Maniou	Maniou	properNoun
Luan	Luan	properNoun
Kasza	Kasza	properNoun
Nedim	Nedim	properNoun
Golts	Golts	properNoun
Hargasova	Hargasova	properNoun
Levan	Lévan	properNoun
Ellatzite	Ellatzite	properNoun
Floraart	Floraart	properNoun
Botash	Botte	properNoun
Rrogozhine	Rogozhine	properNoun
Brabants	Brabants	properNoun
Osieczna	Oseczna	properNoun
Tuncer	Tuncer	properNoun
Incel	Inciter	properNoun
Uncu	non coupé	adjective
Uncu	non taillé	adjective
Uncu	sans coupures	adjective
Uncu	Non coupé	None
Sestriere	Sestriere	properNoun
Andrijana	Andrijana	properNoun
Kosic	Kosic	properNoun
Gundulic	Gunlique	properNoun
Mizuho	Mizuho	properNoun
Bekele	Bekele	properNoun
Milazim	Milazim	properNoun
Kiesling	Kiesling	properNoun
Apulum	Copeau	properNoun
Popera	Pépinière	properNoun
Katsivali	Katsivali	properNoun
Radion	Radion	properNoun
Serhiy	Serhiy	properNoun
Kisberi	Kisberi	properNoun
Ofisi	Ofisi	properNoun
Sreckovic	Sreckovic	properNoun
Baskurt	Bêcheur	properNoun
Sladjana	Sladjana	properNoun
Meggle	Mégre	properNoun
Goce	Gober	properNoun
Bekatorou	Bekatorou	properNoun
Dicle	Dicle	properNoun
Sljivic	Sljivic	properNoun
in spite of the fact that	malgré le fait que	properNoun
Valentinova	Valentinova	properNoun
Aaland	Aaland	properNoun
Dobrova	Dobrova	properNoun
Blitz	le blitz	noun
Blitz	l' attaque éclaire	noun
Blitz	bombarder	verb
Blitz	Blitz	None
Imlek	Imlek	properNoun
Kultur	Kultur	properNoun
Cuprom	Cuprom	properNoun
Fazlovic	Fazlovic	properNoun
Evros	Faire des evros	properNoun
Atif	Atif	properNoun
Hashemi	Hashemi	properNoun
Senida	Senida	properNoun
Bojanic	Bojanic	properNoun
Sicre	Sicré	properNoun
Kalac	Kalac	properNoun
Sajko	Sajko	properNoun
Brankica	Brankica	properNoun
polution	la pollution	noun
polution	la contamination	noun
polution	la profanation	noun
polution	la pollution	None
Safakran	Safakran	properNoun
Gacko	Gambade	properNoun
Esref	Esref	properNoun
Kalman	Kalman	properNoun
Bunjaku	Bunjaku	properNoun
Sandri	Sandri	properNoun
Medicana	Médicana	properNoun
Skelin	Skelin	properNoun
Satev	Satev	properNoun
Valier	Valier	properNoun
Chiritoiu	Chiritoiu	properNoun
Seppo	Seppo	properNoun
Milinic	Milinique	properNoun
Lajmanovska	Lajmanovska	properNoun
Šešelj	Šešelj	properNoun
Kunio	Kunio	properNoun
Michal	Michal	properNoun
Kohavision	Kohavision	properNoun
Baath	Baath	properNoun
Pashko	Pashko	properNoun
Maloutas	Mallétas	properNoun
Lukavica	Lukavica	properNoun
Strikos	Striques	properNoun
Breccia	Breccia	properNoun
Eurovision	Eurovision	properNoun
Velez	Vele	properNoun
grit	grincer	verb
grit	gravillonner	verb
grit	serrer les dents	verb
grit	crisser	verb
grit	le sable	noun
grit	le gravier	noun
grit	le grès	noun
grit	le cran	noun
grit	le gravillon	noun
grit	le gruau de maïs	noun
grit	grincer	None
Kemer	Kemer	properNoun
Panorios	Panoros	properNoun
Naco	Naco	properNoun
Otok	Itok	properNoun
Everaers	Everaers	properNoun
Oskaras	Oskaras	properNoun
Parun	Paru	properNoun
become weak	devenir faible	properNoun
Teofil	Teofil	properNoun
Betim	Bêtime	properNoun
Mercuria	Mercuria	properNoun
Andresen	Andresen	properNoun
Busra	Busra	properNoun
finish telling	terminer	properNoun
Atlantik	Atlantik	properNoun
Hojda	Hojda	properNoun
Campulung	Camula	properNoun
Vinea	Vinea	properNoun
Philips	Philips	properNoun
Ruli	Directeur	properNoun
Monzer	Monzer	properNoun
Hellas	Hellas	properNoun
Bondsteel	Bondsteel	properNoun
Brancoveanu	Brancoveanu	properNoun
Svi	Svi	properNoun
Kalezic	Kalezic	properNoun
Lazareti	Lazareti	properNoun
Putesti	Puesti	properNoun
Kamcevska	Kamcevska	properNoun
Spatafora	Spatafora	properNoun
Tomce	Tomce	properNoun
Veloutsos	Veloutsos	properNoun
Quadriga	la quadrige	noun
Quadriga	Quadrige	None
Abdulmajid	Abdulmajid	properNoun
Annem	Annem	properNoun
Vsat	Vsat	properNoun
Vereya	Vereya	properNoun
Tantawi	Tantawi	properNoun
Boccherini	Boccherini	properNoun
Bularat	Bulle	properNoun
Maqastena	Maqastena	properNoun
Vojo	Voyo	properNoun
Cukrov	Cukrov	properNoun
Sheholli	Sheholli	properNoun
Cajo	Cajo	properNoun
Rovcanin	Rovcanin	properNoun
Neftochim	NEFTOCHIM	properNoun
Sidar	Sidaire	properNoun
Dervish	le derviche	noun
Dervish	Derviche	None
Mani	Mani	properNoun
Vatopedio	Vatopedio	properNoun
Momirov	Momirov	properNoun
Detea	Déchets	properNoun
Tisza	Tisza	properNoun
Tanyu	Tanyu	properNoun
Volmar	Volmar	properNoun
Olena	Olène	properNoun
Curguz	Curguz	properNoun
Alhajouj	Alhajouj	properNoun
Ahlstedt	Ahlstedt	properNoun
Rotthier	Rotthier	properNoun
Erzurum	Erzurum	properNoun
Joao	Joao	properNoun
Venatsanou	Venatsanou	properNoun
Vekeslav	Vekeslav	properNoun
Patrikios	Patrikios	properNoun
Kiril	Kiril	properNoun
Kusadasi	Kusadasi	properNoun
Borrachoz	Borrachoz	properNoun
Lugovoi	Lugovoi	properNoun
Sljivancanin	Sljivancanine	properNoun
Apak	Apak	properNoun
Parthenos	Parthénos	properNoun
Matache	Matache	properNoun
Moravica	Moravique	properNoun
Wiedmann	Wiedmann	properNoun
Kigen	Kigen	properNoun
Erbey	Erbey	properNoun
Zuleeg	Zuleeg	properNoun
Beroev	Beroev	properNoun
Godinska	Godinska	properNoun
Vjekoslav	Vjekoslav	properNoun
Kharafi	Kharafi	properNoun
Milenov	Milenov	properNoun
Kumanovo	Kumanovo	properNoun
Siotis	Siiotis	properNoun
Tufan	Tufan	properNoun
Apo	Apo	properNoun
Forgacs	Fortune	properNoun
Hanim	Hanim	properNoun
Slavenka	Sloiska	properNoun
Isfakat	Isfakat	properNoun
Kosava	Kosava	properNoun
Vojtehovski	Vojtehovski	properNoun
Dacias	Dcias	properNoun
Perper	Perpereur	properNoun
Kastelancic	Kastelancien	properNoun
Decker	Décaper	properNoun
Kreshnik	Kreshnik	properNoun
Volk	Volk	properNoun
Zelenikovo	Zelenikovo	properNoun
Trnka	Trynka	properNoun
snow melt	neige fondre	properNoun
Aamodt	Aamodt	properNoun
Donatas	Donatas	properNoun
Teramo	Teramo	properNoun
Spilios	Spilios	properNoun
Sozopol	Sozopol	properNoun
Petraeus	Petraeus	properNoun
Zappa	Zappa	properNoun
Torfeno	Torfeno	properNoun
Natig	Natig	properNoun
Slodlaka	Slodlaka	properNoun
Tofas	Tofas	properNoun
Infopress	Infopresse	properNoun
Zdeno	Zddeno	properNoun
Trepacka	Trepacka	properNoun
Thorn	l' épine	noun
Thorn	l' arbuste épineux	noun
Thorn	Épine	None
Telespazio	Télespazio	properNoun
Budimir	Budimir	properNoun
Delobel	Delibel	properNoun
Korkoneas	Korkoneas	properNoun
Mihovil	Mihovil	properNoun
Ukio	Ukio	properNoun
Biriya	Biriya	properNoun
Rosenthal	Rosenthal	properNoun
Toulon	Toulon	properNoun
Miriste	Miriste	properNoun
Qerimaj	Qérimaj	properNoun
Stojce	Stojce	properNoun
Sesok	Sesok	properNoun
Kuljis	Kuljis	properNoun
Kallinikos	Kallinikos	properNoun
Bjork	Bjork	properNoun
Ragusa	Ragusa	properNoun
Okcul	Okcul	properNoun
Mece	Mec	properNoun
Panovski	Panovski	properNoun
Kondylis	Kondylis	properNoun
Feal	Se classer	properNoun
Radocaj	Radocaj	properNoun
Ropotamo	Ropotamo	properNoun
Kursine	Kursin	properNoun
EuroNatur	Euronatur	properNoun
Galateca	Galateca	properNoun
Cabaret	le cabaret	noun
Cabaret	le spectacle	noun
Cabaret	le bar	noun
Cabaret	le programme de chansons	noun
Cabaret	Cabaret	None
Lezha	Lezha	properNoun
Baden	Baden	properNoun
Ulaj	Ulaj	properNoun
Dartel	Darte	properNoun
Millett	Millette	properNoun
Mikes	Mikes	properNoun
Latal	Lataleux	properNoun
Plestina	Pesée	properNoun
Kozhuharov	Kozhuharov	properNoun
Nigro	Nigro	properNoun
Nisville	Nisville	properNoun
Crina	Crina	properNoun
Imar	Imar	properNoun
Amasya	Amasya	properNoun
Periclean	Péricléien	properNoun
Metropoll	Métropoll	properNoun
Alston	Alston	properNoun
Pacaci	Pacaci	properNoun
Gonxha	Gonxha	properNoun
Zenun	Zénun	properNoun
Lukanov	Lukanov	properNoun
Lajcak	Lajcak	properNoun
Kulic	Kulique	properNoun
Cremers	Cremers	properNoun
Bulgari	Bulgari	properNoun
Zsolt	Zsolt	properNoun
Momoi	Momoi	properNoun
Milin	Milin	properNoun
Viohalko	Viohalco	properNoun
Daylan	Daylan	properNoun
Ziakos	Ziakos	properNoun
Katsirdakis	Katsfirdakis	properNoun
Aceh	Aceh	properNoun
Fideli	Fideli	properNoun
Blajan	Blajan	properNoun
Nasrat	Nasrat	properNoun
Bruckental	Fructueux	properNoun
Abela	Abela	properNoun
Pindus	Pindus	properNoun
Zug	Zug	properNoun
Telios	Télédiffusion	properNoun
Spago	Spago	properNoun
Transneft	Transneft	properNoun
Bisevo	Bisevo	properNoun
Andrunache	Andrunache	properNoun
Neofit	Néofit	properNoun
Trepce	Tremblement de terre	properNoun
Hyung	Hygiène	properNoun
Avxhi	Avxhi	properNoun
Ajazi	Ajazi	properNoun
Anastase	Anastase	properNoun
Kranju	Kranju	properNoun
Saip	Écaille	properNoun
Tsoukala	Tsoukala	properNoun
Cingiz	Cingiz	properNoun
Eigen	Étiquette	properNoun
Finanzbank	Finanzbank	properNoun
Fandukova	Fandouukova	properNoun
Brezovec	Brezovec	properNoun
Castello	Castello	properNoun
Necatigil	Nécatitigil	properNoun
Nikolaj	Nikolaj	properNoun
Feral	sauvage	adjective
Feral	Sauvage	None
Kamaladdin	Kamaladdin	properNoun
dismantling	le démantèlement	noun
dismantling	le démontage	noun
dismantling	démantèlement	None
Marandou	Marandou	properNoun
Kahn	Kahn	properNoun
Novoberdali	Novoberdali	properNoun
Actros	Actros	properNoun
Artexpo	ArtExpo	properNoun
Dortmund	Dortmund	properNoun
Pashanski	Pashanski	properNoun
Duyne	Duyne	properNoun
Orescu	Orescu	properNoun
Porcelanka	Porcelanka	properNoun
Nuland	Nuland	properNoun
Tekfen	Tekfen	properNoun
Nuriev	Nurv	properNoun
Medvedja	Medvedja	properNoun
Devvarman	Devvarman	properNoun
Shtrentje	Shtrentje	properNoun
Dokovska	Dokovska	properNoun
Čiček	Čiček	properNoun
Gluha	Gluha	properNoun
Videanu	Videanu	properNoun
Ivona	Ivona	properNoun
Nonevski	Nonvski	properNoun
Valdas	Valdas	properNoun
Biondo	Biondo	properNoun
Poitov	Pitov	properNoun
Mici	Mici	properNoun
Buci	Buci	properNoun
Direskeneli	Drieskeneli	properNoun
Valmar	Valmar	properNoun
Vilim	Vif	properNoun
Dr Raed Arafat	Dr Raed Arafat	properNoun
Taki	Taki	properNoun
Nemanic	Nanique	properNoun
Mammadyarov	Mammadyarov	properNoun
Vjekoslava	Vjekoslava	properNoun
Zima	Zima	properNoun
Speira	Speira	properNoun
Kryeziu	Kryeziu	properNoun
Niwa	Niwa	properNoun
Metalno	Metalno	properNoun
Culov	Culov	properNoun
Karaburun	Karaburun	properNoun
Nikolic	Nikolique	properNoun
Zafirovska	Zafirovska	properNoun
Emre	Emré	properNoun
Borbala	Borbala	properNoun
Rafiz	Rafiz	properNoun
Stavropoleos	Stavropoleos	properNoun
Puresic	Puresique	properNoun
Safak	Safer	properNoun
Chifte	Chifte	properNoun
Montobbio	Montobbio	properNoun
Ecofin	Écofin	properNoun
Kljusev	Kljusev	properNoun
Rahmi	Rahmi	properNoun
Pro	pro	noun
Pro	le professionnel	noun
Pro	la prostituée professionnelle	noun
Pro	Pro	None
Parnitha	Parnitha	properNoun
Kazakh	Kazakh	properNoun
Kubiswill	Kubiswill	properNoun
Altit	Altitude	properNoun
Atalay	Atalay	properNoun
Vitaminka	Vitaminka	properNoun
Interart	Interrompu	properNoun
Alkalaj	Alcalaj	properNoun
Moravita	Moravita	properNoun
Tose	Tose	properNoun
Denali	Denali	properNoun
Glavovic	Glavovic	properNoun
Grapsas	Grillage	properNoun
Lokas	Lokas	properNoun
Marinza	Marinza	properNoun
Fuad	Farouche	properNoun
Ferad	Ferrad	properNoun
Raikov	Raikov	properNoun
Srecni	Srecni	properNoun
Kabuli	Kabulie	properNoun
Gakovic	Gakovic	properNoun
Vilovic	Vilovic	properNoun
Srebotnik	Srebotnik	properNoun
Sema	Sema	properNoun
Mahallesi	Mahallesi	properNoun
Dardania	Dardanie	properNoun
Seks	Se vêtir	properNoun
Rahilka	Rahilka	properNoun
Sani	Sani	properNoun
Graz	Grotte	properNoun
McNair	Mcnair	properNoun
Agualusa	Agualusa	properNoun
Webit	Web	properNoun
Hennon	Hennon	properNoun
Andrey	Andrey	properNoun
Kaciu	Kaciu	properNoun
Giulesti	Giulesti	properNoun
Ghetau	Ghétau	properNoun
Shehtanski	Shehtanski	properNoun
Myrda	Myrda	properNoun
Radiotelevizija	RadioTelevizija	properNoun
Ergma	Ergma	properNoun
Topola	Topola	properNoun
Kovachev	Kovachev	properNoun
Artorius	Artorius	properNoun
Krivach	Krivach	properNoun
Zelimir	Zelimir	properNoun
Stevo	Stevo	properNoun
Cimen	Cimen	properNoun
Svjetlana	Svjetlana	properNoun
Sokol	Sokol	properNoun
Gec	Gec	properNoun
Totaj	Totaj	properNoun
Skiadas	Skiadas	properNoun
Belex	Belex	properNoun
Gligor	Gligor	properNoun
Ayyildiz	Ayyildiz	properNoun
Suga	Suga	properNoun
Gulluce	Gulluce	properNoun
Brahimaj	Brahimaj	properNoun
Hrvatinovi	Hrvatinovi	properNoun
Bouraoui	Bouraoui	properNoun
Rugvica	Rugvica	properNoun
Azm	Azm	properNoun
Houliaras	Houliaras	properNoun
Dabetic	Dabetique	properNoun
Stamenka	Stamenka	properNoun
Geus	Geus	properNoun
Amna	Amna	properNoun
Shkoder	Shkoder	properNoun
Donja	Donja	properNoun
Nabarro	Nabarro	properNoun
Semneby	Demi-plan	properNoun
Izmirli	Izmirli	properNoun
TransBalkan	Transbalkan	properNoun
Ani	Ani	properNoun
Begej	Begej	properNoun
Pallini	Pallini	properNoun
Kodheli	Kodheli	properNoun
Reisu-l-ulema	Reisu-l-ulema	properNoun
Fiorenini	Fiorenini	properNoun
Kaqusha	Kaqusha	properNoun
Hepta	Hepsta	properNoun
Zakheos	Zakheos	properNoun
Energie	Énergise	properNoun
Pengezova	Pengezova	properNoun
Ruçi	Ruçi	properNoun
Chronides	Chronches	properNoun
Papathanassiou	Papathanassiou	properNoun
Moammar	Moammar	properNoun
Ranilug	Ranilug	properNoun
Derventa	Derventa	properNoun
Regouzas	Regouzas	properNoun
Balje	Balje	properNoun
Hawton	Hawton	properNoun
Ramazzotti	Ramazzotti	properNoun
Midea	Midée	properNoun
Conev	Congé	properNoun
Kekovic	Kekovic	properNoun
Gulsum	Gulstu	properNoun
Prevalac	Prevalac	properNoun
Litani	Litani	properNoun
Naftanaila	Naftanaila	properNoun
Hadanovic	Handica	properNoun
Lakota	Lakota	properNoun
Lego	le jeu Lego	noun
Lego	Lego	None
Zankov	Zankov	properNoun
Geprata	Geprata	properNoun
Tarbuk	Tarbuk	properNoun
Halkida	Halkida	properNoun
Nadan	Nadan	properNoun
Voest	Voûter	properNoun
Dimitris	Dimitris	properNoun
Rezai	Rezai	properNoun
Berksoy	Berksoy	properNoun
Zadarski	ZADARSKI	properNoun
Radulescu	Radulescu	properNoun
Guto	Guton	properNoun
Hristov	Hristov	properNoun
Nesu	Nesu	properNoun
Galati	Galati	properNoun
Olteanu	Olteanu	properNoun
Tomescu	Tomesu	properNoun
Demekas	Démékas	properNoun
Rethymno	Réthymnie	properNoun
Cahit	Cahit	properNoun
Doda	Doda	properNoun
Schook	Escroquer	properNoun
Ararat	Ararat	properNoun
Masjed	Masjed	properNoun
Dardafon	Dardafon	properNoun
Remake	le remake	noun
Remake	le renouvellement	noun
Remake	refaire	verb
Remake	refaire de nouveau	verb
Remake	Refaire	None
Mutharika	Mutharika	properNoun
Simeonovo	Simonovo	properNoun
Slovnaft	Slovnaft	properNoun
goldsmith	l' orfèvre	noun
goldsmith	orfèvre	None
Bindra	Bindra	properNoun
Jusuf	Jusuf	properNoun
Keramika	Keramika	properNoun
Effigies	l' effigie	noun
Effigies	Effigie	None
Olmert	Olmert	properNoun
Vanev	Vanev	properNoun
Erion	Erion	properNoun
Amfiklia	Amfiklia	properNoun
Maticevic	Maticevic	properNoun
Anthoula	Anthoula	properNoun
Aneta	Aneta	properNoun
Mandoi	Mandoi	properNoun
Krushkova	Krushkova	properNoun
Rusty	rouillé	adjective
Rusty	Rouillé	None
Montupet	Montune	properNoun
Croata	Croate	properNoun
Krstevska	Krstevska	properNoun
Ameti	Amète	properNoun
give an opinion	donner un avis	properNoun
Deligrad	Deligrad	properNoun
Passy	Passager	properNoun
Karpos	Karpos	properNoun
Mello	Mello	properNoun
Tearce	Larme	properNoun
Gokcen	Goûter	properNoun
Gagauzov	Gagauzov	properNoun
Gorisht	Gorisht	properNoun
Loutraki	Loutraki	properNoun
Bozhidar	Bozhidar	properNoun
Kardjali	Kardjali	properNoun
Fitr	Fitr	properNoun
Stanovce	Stanovce	properNoun
Niraj	Niraj	properNoun
Spidla	Spidla	properNoun
Vladuz	Vladuz	properNoun
Sharjah	Sharjah	properNoun
Stelios	Stelios	properNoun
Tezno	Tezno	properNoun
Crivtonencu	Crivtonencu	properNoun
Dauti	Dauti	properNoun
Sota	Sota	properNoun
Borisavljevic	Borisavljevic	properNoun
market-town	ville de marché	properNoun
Gratu	Grotu	properNoun
Hyseni	Hyseni	properNoun
Vangjeli	Vangjeli	properNoun
Cubanismo	Cubanismo	properNoun
Nastia	Nastia	properNoun
Racak	Racak	properNoun
Pekusic	Pekusic	properNoun
Malev	Malev	properNoun
Podstrana	Podstrana	properNoun
Daneva	Daneva	properNoun
Troyan	Troyan	properNoun
Kolay	Kolay	properNoun
Aslik	Assique	properNoun
Chkiponja	Chkiposonja	properNoun
Cun	Cun	properNoun
Zalimkhan	Zalimkhan	properNoun
Zhito	Zhito	properNoun
Isnan	Isnan	properNoun
Bacik	Bacik	properNoun
Ivaylograd	Ivaylograd	properNoun
Ratarstvo	Ratartvo	properNoun
Bojic	Bojic	properNoun
Raichin	Raichin	properNoun
Nistoran	Nistoran	properNoun
Infosystem	Infosystème	properNoun
Hajdari	Hajdari	properNoun
Italgest	Italalgest	properNoun
Ristova	Ristova	properNoun
Nicolaides	Nicolaides	properNoun
Rahimovski	Rahimovski	properNoun
Momiroski	Momiroski	properNoun
Mokrice	Mokrer	properNoun
Marginimea	Marginime	properNoun
Promahonas	Promahonas	properNoun
Tuljkovic	Tuljkovic	properNoun
Stamoulis	Stamoulis	properNoun
Kupresak	Kupresak	properNoun
Tazegul	Tazeul	properNoun
Maden	Fou	properNoun
Blease	Blasser	properNoun
Akkas	Akkas	properNoun
Emina	Emina	properNoun
Furdui	Furdui	properNoun
Codlea	Codlea	properNoun
Tornero	Tornulaire	properNoun
Masukiye	Masukiye	properNoun
Gerritsen	Gerritsen	properNoun
Ganev	Ganev	properNoun
Hercegovacka	Hercegovacka	properNoun
Urlati	Urlati	properNoun
Theoklitos	Théoklitos	properNoun
Miscoci	Malheureux	properNoun
Garavde	Garavde	properNoun
Kieffer	Kieffer	properNoun
Niziris	Niziris	properNoun
Blazina	Blazina	properNoun
Majetic	Majestueux	properNoun
Tighina	Tighain	properNoun
Halliburton	Halliburton	properNoun
Vardar	Vardar	properNoun
Cavtat	Cavtat	properNoun
Callas	Callas	properNoun
Orao	Orao	properNoun
Bashkurti	Bashkurti	properNoun
Partenariat	Partitenariat	properNoun
Zimnicea	Zimnica	properNoun
Margaritis	Margarite	properNoun
Gordeyev	Gordeyev	properNoun
Kilicci	Kilicci	properNoun
Mirdita	Mirthita	properNoun
Bilge	les fond de cale	noun
Bilge	le bouchain	noun
Bilge	la sentine	noun
Bilge	l' eau de cale	noun
Bilge	le renflement	noun
Bilge	Fond de cale	None
Andronescu	Anronescu	properNoun
Valkov	Valkov	properNoun
Anastasov	Anastasov	properNoun
Celsius	celsius	adjective
Celsius	Celsius	None
Zupanovic	Zupanovic	properNoun
Radivoje	Radivoje	properNoun
Kea	Kea	properNoun
Brantner	Branteur	properNoun
Finkel	Fléau	properNoun
Pirita	Pirita	properNoun
Svec	Svec	properNoun
Komani	Komani	properNoun
Nove	Novice	properNoun
Ovidiu	Ovidiu	properNoun
Kavran	Kavran	properNoun
Locher	Locher	properNoun
Parmac	Parmac	properNoun
Ferid	Fertile	properNoun
Radislav	Radis	properNoun
Fotis	Fotis	properNoun
Gacek	Gace	properNoun
Kanbar	Kanbar	properNoun
Lantos	Lantos	properNoun
Ottorino	Ottorino	properNoun
Rakoff	Rakoff	properNoun
Valovoi	Valovoi	properNoun
Campionato	Campionato	properNoun
Zee	Zee	properNoun
Angelova	Angelova	properNoun
Sanjay	Sanjay	properNoun
Kuli	Kuli	properNoun
Papaligouras	Papaligouras	properNoun
Etem	Eem	properNoun
Benka	Benka	properNoun
Uzunov	Uzunov	properNoun
Elitas	Elitas	properNoun
Qosja	Qosja	properNoun
Mitropacup	Mitropacup	properNoun
Salzman	Salzman	properNoun
Mirjanic	Mirjanic	properNoun
Sait	Assainissement	properNoun
Kallia	Kallia	properNoun
Miftiu	Miftiu	properNoun
Tokaca	Tokaca	properNoun
Hrary	Hrary	properNoun
Vihren	Vierge	properNoun
Traistariu	Traistariu	properNoun
Sanarbek	Sanarbek	properNoun
Ihtiman	Ihtiman	properNoun
Dragovest	Draguer	properNoun
Agrocenter	AgroCenter	properNoun
Tripunovic	Tripunovic	properNoun
Kentas	Kentas	properNoun
Istro	Istro	properNoun
Kaspar	Kaspar	properNoun
Smajic	Smajic	properNoun
Stilian	Stilité	properNoun
Basquiat	Basquiat	properNoun
Haydar	Haydar	properNoun
Gavra	Gavra	properNoun
Novi Sad	Novi triste	properNoun
Ghise	Gousse	properNoun
rerelease	rerelease	properNoun
shoot down	abattre	properNoun
Afrim	Afrim	properNoun
Loach	Loach	properNoun
Haan	Haan	properNoun
Paparizou	Paparizou	properNoun
Bahadir	Bahadir	properNoun
Klecak	Klecak	properNoun
Cacak	Cacak	properNoun
Sejla	Sejla	properNoun
Prilep	Prilep	properNoun
Trendafil	Trendafil	properNoun
Turkes	Turcs	properNoun
Nona	Non-	properNoun
Longares	Longueurs	properNoun
Nakazawa	Nakazawa	properNoun
Radika	Radika	properNoun
Vasilyov	Vasilyov	properNoun
Borione	Borione	properNoun
Guruz	Gourouz	properNoun
Veche	Vech	properNoun
Florescu	Florescu	properNoun
Dugopolje	Dugopolje	properNoun
Reiteralm	Réiteralm	properNoun
Arvi	Arvien	properNoun
Penezzi	Pénézzi	properNoun
Stefanou	Stefanou	properNoun
Cavit	Caviter	properNoun
Bogavac	Bogavac	properNoun
Dondar	Dondar	properNoun
Cuccurin	Cuccurine	properNoun
Theodora	Theodora	properNoun
Vrijer	Vrijer	properNoun
Brajovic	Brajovic	properNoun
Atanas	Atanas	properNoun
Kibet	Kibet	properNoun
Smiljka	Smiljka	properNoun
Burgin	Burine	properNoun
Ayvalik	Ayvalik	properNoun
Charlotta	Charlotta	properNoun
Sikorski	Sikorski	properNoun
Pirvu	Pirvu	properNoun
Boksi	Boksi	properNoun
Gallucci	Gallucci	properNoun
Glavbolgarstroy	Glavolgarstroy	properNoun
Christo	Christo	properNoun
Zeljka	Zeljka	properNoun
Eksi	Eksi	properNoun
Alexandrovo	Alexandrovo	properNoun
Altuntas	Altuntas	properNoun
Berlakovich	Berlakovich	properNoun
Esad	Esad	properNoun
Mihatovici	Mihatovici	properNoun
Manos	Manos	properNoun
Kokotas	Kokotas	properNoun
Aikaterini	Aikiaterini	properNoun
in the amount of	en une quantité de	properNoun
Omerovic	Omerovic	properNoun
Kurti	Kurti	properNoun
Thaagaard	Thagaard	properNoun
Fura	Fura	properNoun
Drais	Drais	properNoun
Hajdaraga	Hajdaraga	properNoun
Galip	Galipa	properNoun
Strizic	Strizique	properNoun
Barbur	Barbour	properNoun
Camii	Camii	properNoun
Taleska	Taleska	properNoun
Cicic	Cicic	properNoun
be amenable	être agréable	properNoun
Lykaion	Lykaion	properNoun
Steirn	Steirn	properNoun
Pippidi	Pippidi	properNoun
Dverce	Dvier	properNoun
Sivric	Sivrique	properNoun
Zeljo	Zeljo	properNoun
Loquet	Loquet	properNoun
Transcaucasus	Transcaucasus	properNoun
Amajlije	Amajlije	properNoun
Iannuci	Iannucci	properNoun
Maldjanska	Maldjanska	properNoun
Kukum	Kukum	properNoun
Fiedler	Fiedler	properNoun
Desa	Dessert	properNoun
Oliveira	Oliveira	properNoun
Hagi	Hagi	properNoun
Shishe	Tremper	properNoun
Zahid	Zahid	properNoun
Seci	Seci	properNoun
Rrustem	Rrustem	properNoun
expiate	expier	verb
expiate	expier	None
Dobrin	Dobrin	properNoun
Oudeniotis	Ourdeniotis	properNoun
Bearpark	Bearpark	properNoun
Evoramons	Évoluer	properNoun
Sletzinger	Sletzinger	properNoun
Sapka	Sapka	properNoun
Brnica	Brnica	properNoun
Iraklis	Irraklis	properNoun
Donik	Donik	properNoun
Ulusoy	Ulusoy	properNoun
Mamit	Mamit	properNoun
Calea	Molleton	properNoun
Birgit	Birgit	properNoun
Saban	Saban	properNoun
Retel	Creuser	properNoun
Crcorija	Crcorija	properNoun
Antin	Antin	properNoun
Ardjan	Ardjan	properNoun
Kuroda	Kuroda	properNoun
Slavov	Slavov	properNoun
Sasojevic	Spasojevic	properNoun
Alibeyoglu	Alibeyoglu	properNoun
Razoare	Razoare	properNoun
Esbas	Esbas	properNoun
Syriopoulos	Syriopoulos	properNoun
Otisiste	Otisiste	properNoun
Socor	Socor	properNoun
Bulent	Bultent	properNoun
Nacev	Nacev	properNoun
Gustavson	Gustavson	properNoun
Bose	Bose	properNoun
Meho	Meho	properNoun
Areos	Areos	properNoun
Flensburg	Flensburg	properNoun
Cavcav	Cavcav	properNoun
Kronos	Kronos	properNoun
Chervena	Cervicule	properNoun
Val d'Isere	Val d'Isère	properNoun
Vlaho	Vlaho	properNoun
Nurkse	Nurkse	properNoun
Nunet	Nuque	properNoun
Aygaz	Aygaz	properNoun
Konavle	Konavle	properNoun
Mavraj	Mavraj	properNoun
Evry	Élire	properNoun
Boarov	Boarov	properNoun
Vlachandrea	Vlachandrea	properNoun
Serbetcioglu	Serbetcioglu	properNoun
Vukadin	Vicukadin	properNoun
Mihaileanu	Mihailanu	properNoun
Banat	Banat	properNoun
Zivinci	Zivinci	properNoun
Brentan	Brentan	properNoun
Troyanov	Troyanov	properNoun
Eurowaves	EUROWAVES	properNoun
Mladenovska	Mladenovska	properNoun
Zog	Zoguer	properNoun
Shqiperia	Shqiperia	properNoun
Aureus	Aureus	properNoun
Diwaniya	Diwaniya	properNoun
Vlasina	Vlasina	properNoun
Craiova	Craiova	properNoun
Lordi	Lordi	properNoun
Belupo	Belupo	properNoun
Izair	Izair	properNoun
Stoyanov	Stoyanov	properNoun
Puhaleva	Puhaleva	properNoun
Alcatraz	Alcatraz	properNoun
Lapovo	Lapovo	properNoun
Berguzar	Berguzar	properNoun
Kapanoglu	Kapanoglu	properNoun
Pajkovic	Pyjkovic	properNoun
Pavleski	Pavleski	properNoun
Montmontaza	Montmontaza	properNoun
Domi	Domi	properNoun
Pudgomer	Pudgomère	properNoun
Cedevita	Cedevita	properNoun
Elmar	Elmar	properNoun
Meyerhold	Meyerhold	properNoun
Sekovici	Sekovici	properNoun
Orahovica	Orahovica	properNoun
Crin	Crin	properNoun
Pic	Pic	properNoun
Astous	Astucieux	properNoun
Buhaescu	Buhaesu	properNoun
Mastella	Mastella	properNoun
Iyer	Iyer	properNoun
Polikastro	Polikastro	properNoun
Popovski	Popovski	properNoun
Foto	Foto	properNoun
Tivar	Tivar	properNoun
Dojcin	Dojcin	properNoun
Naturkraft	Naturel	properNoun
Dadacus	Dadacus	properNoun
Bradtke	Bradtke	properNoun
Gueant	Goué	properNoun
Moznik	Moznik	properNoun
Cordez	Cordon	properNoun
Karlovci	Karlovci	properNoun
Peljesac	Peljesac	properNoun
Beja	Beja	properNoun
Banovo	Banovo	properNoun
boyarhood	boissonnerie	properNoun
Georgiadis	Georgiadis	properNoun
Fedja	Fedja	properNoun
Bacevic	Bacvic	properNoun
Lisena	Lisena	properNoun
Sarinic	Sarinique	properNoun
Zivota	Zivota	properNoun
Ierapetra	Ierapétara	properNoun
Skarcic	Skicic	properNoun
Reygadas	Reygadas	properNoun
Ozyurek	Ozyurek	properNoun
Srzentic	Srzentic	properNoun
Vidishiqi	Vidishiqi	properNoun
Pazarlama	Pazarlama	properNoun
Islami	Islami	properNoun
Aqsa	AQSA	properNoun
Moudatsaki	Moudatsaki	properNoun
Sfantu	Sfantu	properNoun
Araz	Araze	properNoun
Maslarova	Maslarova	properNoun
Refik	Repiquier	properNoun
Nistelroij	Nistelrooy	properNoun
Puric	Purique	properNoun
Voskopoje	Voskopoje	properNoun
Sippel	Sippel	properNoun
Bitonja	Bitonja	properNoun
Kopacki	Kopacki	properNoun
Zijad	Zijad	properNoun
Ronaldinho	Ronaldinho	properNoun
Petrascu	Pétreur	properNoun
Ivanec	Ivanec	properNoun
Shpend	Se brouiller	properNoun
Luspa	Luspa	properNoun
Proto	Proto	properNoun
Dunkel	Dunkel	properNoun
Sassi	Sassi	properNoun
Balorda	Balora	properNoun
Rebro	Rébriquer	properNoun
Burgenstock	Burgène	properNoun
Sanmartin	Sanmartin	properNoun
Borowski	Borowski	properNoun
Antoaneta	Antoaneta	properNoun
Wolfsburg	Wolfsburg	properNoun
Asklepion	Asklepion	properNoun
Keraterm	Kératerme	properNoun
Nauman	Naumain	properNoun
Boudella	Boudella	properNoun
Fidan	Fidan	properNoun
Avgoulis	Avgoulis	properNoun
Milijas	Milijas	properNoun
Liel	Liel	properNoun
Kasa	Kasa	properNoun
Paraschiva	Paraschiva	properNoun
Ercel	Ercel	properNoun
Naseer	Naseur	properNoun
Zettel	Zettel	properNoun
Zulu	zoulou	adjective
Zulu	le Zoulou	noun
Zulu	zoulou	None
Tarkan	Tarkan	properNoun
Hagia	Hagia	properNoun
Arton	Arton	properNoun
Kikinda	Kikinda	properNoun
Heroi	Héroïne	properNoun
Sutka	Sutka	properNoun
Dobrica	Dobrica	properNoun
Ozalp	Ozalp	properNoun
Rada	Rada	properNoun
Hojamuhamedov	Hojamuhamedov	properNoun
Binger	Courir	properNoun
Dautovski	Dauvski	properNoun
Zogu	Zogu	properNoun
Galinec	Galinec	properNoun
Plakentia	Plakentia	properNoun
Mus	Module	properNoun
Gon	Gon	properNoun
Oks	Oks	properNoun
Saranovic	Saranovic	properNoun
Stupar	Stupide	properNoun
Siegmaringen	Sigmaringen	properNoun
Ellam	Ellam	properNoun
Hoh	Hoh	properNoun
Lorak	Lorak	properNoun
Popijac	Popijac	properNoun
Culjevic	Culjevic	properNoun
Haos	Haos	properNoun
FestiValium	Festivalium	properNoun
Gavranovic	Gavranovic	properNoun
Polat	Polate	properNoun
Tonci	Tonne	properNoun
Leblebi	Leblebi	properNoun
Floryhen	Floryhen	properNoun
Begolli	Begolli	properNoun
Sakkas	Sakkas	properNoun
Stavre	Stavre	properNoun
Midas	Midas	properNoun
Fermani	Fermani	properNoun
Poth	Piqûre	properNoun
Machacek	Maillard	properNoun
Mafra	Mafra	properNoun
Gradina	Gradina	properNoun
Klinsmann	Klinsmann	properNoun
Staritrg	Étoile	properNoun
Bankar	Banalaire	properNoun
Mustafaj	Mustafaj	properNoun
Osterreich	Osterreich	properNoun
Mata	Mata	properNoun
Bakardzhiev	Bakardzhiev	properNoun
Halis	Halis	properNoun
Analitika	Analitika	properNoun
Agron	Agron	properNoun
Rruka	Rruka	properNoun
Ademantios	Ademantios	properNoun
Surutkovici	Surutkovici	properNoun
Pashaj	Pachaj	properNoun
Ceu	CEU	properNoun
Dardenne	Dardenne	properNoun
Niarchos	Narchos	properNoun
Vlach	Vlach	properNoun
Banisch	Banisch	properNoun
Baranowski	Baranowski	properNoun
Mekelhani	Mekelhani	properNoun
Livorno	Livourne	properNoun
Hotit	Hotti	properNoun
Abbottabad	Abbottabad	properNoun
Hoop	le cerceau	noun
Hoop	le cercle	noun
Hoop	l' arceau	noun
Hoop	cercler	verb
Hoop	fretter	verb
Hoop	mettre des obstacles	verb
Hoop	Cerceau	None
Cosmopolis	Cosmopolis	properNoun
Kalinovik	Kalinovik	properNoun
Povratak	Povratak	properNoun
Poznatov	Poznatov	properNoun
Cepoi	CEPOI	properNoun
Stadnik	Stadnik	properNoun
Margo	Marier	properNoun
Xebat	Xebat	properNoun
Viteazu	Vitezu	properNoun
Murnau	Murnau	properNoun
Raska	Raska	properNoun
Krapp	Krapp	properNoun
Filmmor	Filmeur	properNoun
Guttenberg	Guttenberg	properNoun
Karlovy	Karlovie	properNoun
Vasilopoulos	Vasilopoulos	properNoun
Hamzo	Hamzo	properNoun
Insite	Insiter	properNoun
Samac	Samac	properNoun
Blagovcanin	Blagovcanin	properNoun
Daun	Daunde	properNoun
DigitAlb	Digital	properNoun
Vladkovic	Vladkovic	properNoun
Rashkov	Rashkov	properNoun
Kresovic	Kresovic	properNoun
Koelman	Koelman	properNoun
Vanyo	Vanyo	properNoun
Temo	Temo	properNoun
Dol	Dol	properNoun
Bjorn	Bjorn	properNoun
Movilesti	Movileesti	properNoun
Albright	Albumril	properNoun
Makpetrol	Makpetrol	properNoun
Draginja	Draginja	properNoun
Cherneva	Cherneva	properNoun
Gerta	Gerta	properNoun
Acevska	Acevska	properNoun
Lumezi	Lumumezi	properNoun
Koviljaca	Koviljaca	properNoun
Prce	Preuve	properNoun
Venko	Venko	properNoun
Cazac	Cazac	properNoun
Odos	Odos	properNoun
Khirbet	Khirbet	properNoun
Budimljansko	Budimljansko	properNoun
Grammatiko	Grammatiko	properNoun
Smithfield	Smithfield	properNoun
Sordo	Sordo	properNoun
Kanadoglu	Kanadoglu	properNoun
Sefer	Sévérir	properNoun
Makroekonomija	Makroekonomija	properNoun
Rogner	Rogner	properNoun
Tanter	Branche	properNoun
Maris	Maris	properNoun
Terem	Term	properNoun
Veton	Veton	properNoun
Bokeljka	Bokeljka	properNoun
Godog	Godogle	properNoun
Kefaloyiannis	Kéfaloyelis	properNoun
Martani	Martani	properNoun
Westerdam	Westerdam	properNoun
Mamberti	Mamberti	properNoun
Bedjaoui	Bedjaoui	properNoun
Chelopechene	Chopechène	properNoun
Emportal	Emprateur	properNoun
Agip	Agitation	properNoun
Suncica	Suncica	properNoun
Fotyge	Fotyge	properNoun
Wes	Nous s	properNoun
Mujahed	Mujahed	properNoun
Heron	l' héron	noun
Heron	Héron	None
Somdev	Somdev	properNoun
Borissov	Borissov	properNoun
Kargov	Kargov	properNoun
Corea	Coréen	properNoun
Arbeh	Arbeh	properNoun
Lambrakis	Lambrakis	properNoun
Krecane	Krécane	properNoun
Vlachou	Vlachou	properNoun
Kohorta	Kohorta	properNoun
Musab	Musaté	properNoun
Raptopoulos	Raptopoulos	properNoun
Hamrouni	Hamrouni	properNoun
Palomba	Palomba	properNoun
Bobovac	Bobovac	properNoun
Stümmler	Stoummler	properNoun
Ibrahimova	Ibrahimova	properNoun
Vasileios	Vasileios	properNoun
Corbic	Corbic	properNoun
Buja	Buja	properNoun
Seli	Seli	properNoun
Candar	Candar	properNoun
Birbili	Birbili	properNoun
Slovenije	Slovenije	properNoun
Panonska	Panonska	properNoun
Lavrio	Lavrio	properNoun
Belcista	Belcista	properNoun
Bledi	Bledi	properNoun
Karasu	Karasu	properNoun
Metropolit	Métropole	properNoun
Naser	Naser	properNoun
Meddzida	Meddzida	properNoun
Ustasha	Ustasha	properNoun
Svilengrad	Svilengrad	properNoun
Paravac	Paravac	properNoun
Benelux	Benelux	properNoun
Kadem	Kadem	properNoun
Semenic	Séminaire	properNoun
Gershman	Gershman	properNoun
Ozaki	Ozaki	properNoun
Prelvukaj	Prelvukaj	properNoun
Armen	Armée	properNoun
Postbank	Postal	properNoun
Rasa	Rasa	properNoun
Tanaskovic	Tanaskovic	properNoun
Praktiker	Praktiker	properNoun
Calovic	Calovaire	properNoun
Ingmar	Ingélateur	properNoun
Sarus	Sarus	properNoun
Radmir	Radmir	properNoun
Misevi	Misevi	properNoun
Nake	Nouer	properNoun
Goran	Goran	properNoun
Milutin	Milutin	properNoun
Bagaudinova	Bagaudinova	properNoun
Lele	Lele	properNoun
Kriens	Kriens	properNoun
Siljan	Siljan	properNoun
Vereckei	Vereckei	properNoun
Stournaras	Stournaras	properNoun
Biljarovska	Biljarovska	properNoun
Lugan	Lugan	properNoun
Dimitrieski	Dimitrieski	properNoun
Butchart	Boucher	properNoun
Pantev	Pantev	properNoun
Zhivic	Zhivique	properNoun
Lastva	Lastva	properNoun
Sirmen	Sirmen	properNoun
Haxhiu	Haxhiu	properNoun
Tercan	Tercan	properNoun
Mishig	Mishig	properNoun
Uyar	Uyar	properNoun
Borkovic	Borkovic	properNoun
Prosveta	Prosveta	properNoun
Shankar	Shankar	properNoun
Masha	Masha	properNoun
Asagoe	Asagoite	properNoun
Breytenbach	Breytenbach	properNoun
Zito	Zito	properNoun
Fundora	Fundora	properNoun
Rifat	Rifat	properNoun
Paspalj	Paspalj	properNoun
Heybeliada	Heybeliada	properNoun
Savovska	Savovska	properNoun
Dionysopoulos	Dionysopoulos	properNoun
Memlisht	Mminard	properNoun
Dinga	Dinga	properNoun
Balkenende	Balkenende	properNoun
Podlugovi	Podlugovi	properNoun
Radmilovic	Radmilovic	properNoun
Lutescu	Lutescu	properNoun
Tetovo	Tetovo	properNoun
Davudo	Davido	properNoun
Stefanos	Stefanos	properNoun
Kregar	Krégar	properNoun
Barçin	Barçin	properNoun
Strasek	Strasek	properNoun
Socceroos	Socceroos	properNoun
Euroblic	Euro	properNoun
Petev	Peti	properNoun
Fadata	Fadata	properNoun
Hytiris	Hytiris	properNoun
Melrose	Mélrose	properNoun
Halili	Halili	properNoun
Iraqis	Irakiens	properNoun
Abhinav	Abhinav	properNoun
Skuletic	Succulent	properNoun
Nexe	Nexe	properNoun
Grevena	Grevena	properNoun
Triantafylla	Trantafylla	properNoun
Khamis	Khamis	properNoun
Hoxhas	Hoxhas	properNoun
Gogala	Gogala	properNoun
Dobruja	Dobruja	properNoun
Amadeu	Amadeu	properNoun
Vitalie	Vitalie	properNoun
Slavuljica	Slavuljica	properNoun
Kresevo	Kresevo	properNoun
Ratesh	Tarifsh	properNoun
Aytos	Aytos	properNoun
Plushenko	Plushenko	properNoun
Dukoski	Dukoski	properNoun
Muhamed	Muhadé	properNoun
Bozkurt	Bozkurt	properNoun
Isyar	Isyar	properNoun
Lypjani	Lypjani	properNoun
Petrotel	Pétrotel	properNoun
Niga	Niga	properNoun
scribe	le scribe	noun
scribe	écrire	verb
scribe	scribe	None
Prgomet	Prgomètre	properNoun
Koru	Koru	properNoun
Karaucak	Karucak	properNoun
Sandero	Sandero	properNoun
Paschi	Paschi	properNoun
Kungulovski	Kungulovski	properNoun
Pauna	Pauna	properNoun
Sabliere	Sabliere	properNoun
Tunc	Tunc	properNoun
Bartok	Bartok	properNoun
Zitopolog	Zitopology	properNoun
Curak	Curif	properNoun
Tosev	Tosev	properNoun
Lalova	Lalova	properNoun
Ruspatent	Roussin	properNoun
Teikhos	Teikhos	properNoun
Abdelilah	Abdelilah	properNoun
Korel	Corail	properNoun
Idrac	Idrac	properNoun
Bajadera	Bajadera	properNoun
Bilazora	Bilazora	properNoun
Pecenkovic	Pecenkovic	properNoun
Oescus	Oescus	properNoun
Corp	Corpes	properNoun
Finmetals	Finale	properNoun
Ilfov	ILfov	properNoun
Sinaia	Sinaia	properNoun
Hasanramaj	Hasanramaj	properNoun
Barun	Barun	properNoun
Caniaris	Canaris	properNoun
Bisha	Bisha	properNoun
Rimet	Rideau	properNoun
Harisa	Harisa	properNoun
Foxman	Foxman	properNoun
Katsunori	Katsunori	properNoun
Nahr	Nahr	properNoun
Eon	le temps	noun
Eon	la période	noun
Eon	Eon	None
Rudjer	Rudjer	properNoun
Kutadgu	Kutadgu	properNoun
Axarlian	Axarlien	properNoun
Brajkovici	Brajkovici	properNoun
Llogara	Llogara	properNoun
Rondot	Rondot	properNoun
Elpida	Elpida	properNoun
Enel	Énorme	properNoun
Kahani	Kahani	properNoun
Partesh	Démarche	properNoun
Senadin	Senadin	properNoun
Matica	Matica	properNoun
Srpca	SRPCA	properNoun
Ferronikel	Ferronikel	properNoun
Dindar	Dinder	properNoun
Zicherman	Zichaman	properNoun
Obering	Dépassement	properNoun
Bogaciu	Bogaciu	properNoun
Erdurmaz	Erdurmaz	properNoun
Lipkovo	Lipkovo	properNoun
Hajredin	Hajredin	properNoun
Cilvegozu	Cilvegozu	properNoun
Horezu	Horezu	properNoun
Vouliarati	Vouliarati	properNoun
Bougartchev	Bougartchev	properNoun
Kuban	Kuban	properNoun
Tsardanidis	Tsardanidis	properNoun
Lela	Lela	properNoun
Kastratovic	Kastratovic	properNoun
be in control of	contrôler	properNoun
Zeugma	Zeugma	properNoun
Boyanov	Boyanov	properNoun
Gholam	Gholam	properNoun
Maslinica	Maslinica	properNoun
Darabos	Darabos	properNoun
Klemenko	Klemenko	properNoun
Parham	Parham	properNoun
Filandra	Filandra	properNoun
Ovadya	Ovadya	properNoun
Murska	Murska	properNoun
Ortac	Ortac	properNoun
Plamadeala	Plamadeale	properNoun
Nemo	Nemo	properNoun
Envitec	Envière	properNoun
DenizBank	Denizbank	properNoun
regurgitate	régurgiter	verb
regurgitate	refluer	verb
regurgitate	rendre	verb
regurgitate	régurgiter	None
Silovo	Silovo	properNoun
Borac	Borac	properNoun
Puhalo	Puhalo	properNoun
Melikoff	Mélikoff	properNoun
Bilbilovska	Bilbilovska	properNoun
Christodoulou	Christodoulou	properNoun
Ancona	Ancône	properNoun
Nanev	Nanev	properNoun
Sretenovic	Srétenovic	properNoun
Milososki	Milososki	properNoun
Karbala	Karbala	properNoun
Natron	Natron	properNoun
Marinac	Marinac	properNoun
Nazassi	Nazassi	properNoun
Destani	Destani	properNoun
Raboteg	Raboter	properNoun
Kul	Kuls	properNoun
Zbogar	Zébogar	properNoun
Nakovska	Nakovska	properNoun
Zall	Zall	properNoun
Kojen	Kojen	properNoun
Bina	Bina	properNoun
Vagit	Vague	properNoun
Szczyglo	Szczyglo	properNoun
Magdalini	Magdalini	properNoun
Lokaj	Lokaj	properNoun
Corcuera	Corcuera	properNoun
Samolov	Samolov	properNoun
Husamettin	Husamettetin	properNoun
Tirman	Tirman	properNoun
Termoelektro	Termoelektro	properNoun
Muselimovic	Musélimovic	properNoun
Henning	Hennissant	properNoun
Sandevo	Sandevo	properNoun
Zeljezare	Zeljezare	properNoun
Urstad	Urrstad	properNoun
Sh	SH	properNoun
Bosmal	Bosmal	properNoun
Delioglu	Delioglu	properNoun
Afrodisias	Afrodisias	properNoun
Prudentino	Prudentino	properNoun
Rafti	Rafti	properNoun
Sinirlioglu	Sinirioglu	properNoun
Donmez	Donmez	properNoun
Sinapsi	Sinapsi	properNoun
Lehar	Lehar	properNoun
Salome	Salé	properNoun
Tsvetana	Tsvetana	properNoun
Irinej	Irinej	properNoun
Berceanu	BERCANU	properNoun
Symms	Symbolise	properNoun
Pollo	Pollos	properNoun
Vanli	Vanli	properNoun
Behar	Auparavant	properNoun
Bin	le coffre	noun
Bin	la boîte	noun
Bin	l' huche	noun
Bin	jeter à la poubelle	verb
Bin	mettre dans un coffre	verb
Bin	Poubelle	None
Uskul	Uskul	properNoun
Herczog	Herczog	properNoun
Mateusz	Mateusz	properNoun
Hemteks	Hémâches	properNoun
Anestis	Anestiste	properNoun
Sjeverin	Sjeverin	properNoun
Mousavi	Mousavi	properNoun
Mamaia	Mamana	properNoun
Skero	Skéron	properNoun
Gokalp	Gokalp	properNoun
Dementieva	Démenceva	properNoun
Ogur	Ogur	properNoun
Anouar	Anouar	properNoun
Calafat	Calafat	properNoun
Bayar	Bayar	properNoun
Pandeli	Pandeli	properNoun
Belma	Belma	properNoun
Burkay	Burkay	properNoun
Mujeres	Mujeres	properNoun
Lijeva	Lijeva	properNoun
Harilaq	Harilaq	properNoun
Ihsan	Ihsan	properNoun
globe	le globe	noun
globe	la terre	noun
globe	la sphère	noun
globe	globe	None
Sliven	Édigé	properNoun
Mazreku	Mazreku	properNoun
Ponikve	Ponikve	properNoun
Priluza	Priluza	properNoun
Dragoi	Dragoi	properNoun
Wolthers	Wolther	properNoun
Meron	Méron	properNoun
Grasu	Grasu	properNoun
Havolli	Havolli	properNoun
Cvitisic	Cvitisique	properNoun
Anastopoulos	Anastopoulos	properNoun
Celal	Celique	properNoun
Metheny	Métoulé	properNoun
Vassa	Vassa	properNoun
Tidan	Marée	properNoun
Plakokefalou	Plakokefalou	properNoun
Hellebaut	Hellebaut	properNoun
Itzhak	Itzhak	properNoun
Wouters	Wouters	properNoun
Vetvendosje	Vetevendosje	properNoun
Lavdrim	Laver	properNoun
Dedaj	Dedaj	properNoun
Lidio	Lidio	properNoun
Mincev	Mincev	properNoun
Nadi	Nadi	properNoun
Mermer	Smermer	properNoun
Zagrebacki	Zagrebacki	properNoun
Totyu	Totyu	properNoun
Agrapidis	Agrapidis	properNoun
Igantova	Igantova	properNoun
Golubac	Golubac	properNoun
GarantiBank	Garantibank	properNoun
Perviz	Perviz	properNoun
Veles	Veles	properNoun
Thalassokosmos	Thalassokosmos	properNoun
Gur	Gur	properNoun
Nishi	Nishi	properNoun
reconsecration	reconstitution	properNoun
Makstil	Makstil	properNoun
Deimer	Démieur	properNoun
Anguila	Anguila	properNoun
Kanev	Kanev	properNoun
Erdinc	Erdinc	properNoun
Velikov	Velikov	properNoun
Meola	Meola	properNoun
Skenderbej	Skenderbej	properNoun
Imi	Imi	properNoun
Patara	Patara	properNoun
Matsis	Matsis	properNoun
Lajčak	Lajčak	properNoun
Bet	le pari	noun
Bet	parier	verb
Bet	miser	verb
Bet	parier sur	verb
Bet	Pari	None
Falassarna	Falassarna	properNoun
Alpach	Alpach	properNoun
Ramstore	Ramstore	properNoun
Parvan	Parvan	properNoun
Crnjanski	Crnjanski	properNoun
Knudsen	Knudsen	properNoun
Fais	FAIS	properNoun
Alka	Alka	properNoun
Petrovschi	Petrovschi	properNoun
Chereches	Chereches	properNoun
Sifnios	Sifnios	properNoun
Aca	Aca	properNoun
Bolozan	Bolozan	properNoun
Pibulsonggram	Pibulsonggram	properNoun
Koceva	Koceva	properNoun
Bihor	Bihor	properNoun
Knaus	Knaus	properNoun
Leuenberger	Leuenberger	properNoun
Molliqaj	Molliqaj	properNoun
Kocsis	Kocsis	properNoun
Roubini	Roubini	properNoun
Madzarac	Madzarac	properNoun
hit back	riposter	verb
hit back	frapper en retour	verb
hit back	se venger	verb
hit back	menacer	verb
hit back	riposter	None
Kule	Kule	properNoun
Ehpeditio	Ehpedio	properNoun
Kala	Kala	properNoun
Gollia	Gollia	properNoun
Stjepko	Stjepko	properNoun
Dakovica	Dakovica	properNoun
Finansbank	Finansbank	properNoun
Novakovic	Novakovic	properNoun
Dervishi	Dervishi	properNoun
Remedika	Remède	properNoun
Nucci	Nucci	properNoun
Elchin	Elchin	properNoun
Thermes	Thermique	properNoun
Carteron	Carton	properNoun
Kosher	kascher	adjective
Kosher	Kascher	None
Abazi	Abazé	properNoun
Ersin	Ersin	properNoun
Anila	Anila	properNoun
Mehve	Mesurer	properNoun
Danijela	Danijela	properNoun
Arda	Arda	properNoun
Dolmabahce	Dolmabahce	properNoun
Nazaryan	Nazaryan	properNoun
Pompeiu	Pompéiu	properNoun
Olten	Olen	properNoun
Korca	Corca	properNoun
Deveselu	Deveselu	properNoun
Kouretas	Kourettas	properNoun
Velin	Velours	properNoun
Godinac	Godinac	properNoun
Sagynbaeva	Sagynbaeva	properNoun
Drini	Driness	properNoun
Halki	Halki	properNoun
Todorova	Todorova	properNoun
Komuna	Komuna	properNoun
Rypdal	Rypdal	properNoun
Tromblon	Tromblon	properNoun
Kirkuk	Kirkuk	properNoun
Kapo	Kapo	properNoun
Ataman	Ataman	properNoun
Malinova	Malinova	properNoun
Bayram	Bayram	properNoun
Edelbacher	Edelbacher	properNoun
Bishevac	Bishevac	properNoun
Emine	Éminence	properNoun
Shuleva	Shuleva	properNoun
Ballad	la ballade	noun
Ballad	la romance	noun
Ballad	la chanson populaire	noun
Ballad	Ballade	None
Lesok	Lesok	properNoun
Stelio	Stelio	properNoun
Magharebia	Magharebie	properNoun
Tepecik	Tepecik	properNoun
Seutus	Seutus	properNoun
Ushuaia	Ushuaia	properNoun
Gokturk	Gokturk	properNoun
Salchin	Salchin	properNoun
Leshak	Festival	properNoun
Sacan	Sachan	properNoun
Stamkov	Stamkov	properNoun
Trajko	Trajko	properNoun
Pavarotti	Pavarotti	properNoun
Remes	Remes	properNoun
Bartosz	Bartosz	properNoun
Gorast	Gonflement	properNoun
Kamerfest	Kamerfest	properNoun
Colliers	le charbonnier	noun
Colliers	le mineur	noun
Colliers	Collateurs	None
Basi	Bas	properNoun
Mt	Mt	properNoun
Gasic	Gastrique	properNoun
Vsekiden	Vsekiden	properNoun
Bdama	Bdama	properNoun
Alibeaj	Alibeaj	properNoun
Idil	Idiot	properNoun
Mirsad	Mirsad	properNoun
Labina	Labina	properNoun
Mucahit	Mucahit	properNoun
Albitson	Albson	properNoun
Arne	Arne	properNoun
Selmo Cikotic	Selmo Cikotic	properNoun
Stevce	Stevce	properNoun
Zelenika	Zelenika	properNoun
Epoka	Époka	properNoun
Tunga	Tunga	properNoun
Errico	Errico	properNoun
Tmusic	Tmusic	properNoun
Gunnr	Gunnr	properNoun
Pelivan	Pelivan	properNoun
Thomopoulos	Thomopoulos	properNoun
Diculescu	Diculescu	properNoun
Cojocaru	Cojocaru	properNoun
Guanglie	Guanglie	properNoun
Gallegly	Galle	properNoun
Alin	Alin	properNoun
Pourtabatabaei	Pourtabatabaei	properNoun
Promohotel	Promoteur	properNoun
Nana	Nana	properNoun
Tusha	Tutha	properNoun
Dincic	Dincique	properNoun
Koteski	Koteski	properNoun
Belge	Belge	properNoun
Alb	l' aube d'un prêtre	noun
Alb	Alb	None
Sagita	Sagita	properNoun
Bogner	Bogner	properNoun
Goldner	Goldner	properNoun
Nemescu	Nemescu	properNoun
Encarta	Encarta	properNoun
Botteri	Botteri	properNoun
Taranu	Taranu	properNoun
Kurban	Kurban	properNoun
Dijmarescu	Dijmarescu	properNoun
Urosevac	Urosevac	properNoun
Matav	Matav	properNoun
Elektrik	Elektrik	properNoun
Resen	Restention	properNoun
Elka	Restention	properNoun
Wittman	Wittman	properNoun
Novorossisk	Novorossiysk	properNoun
Shukarie	Shukarie	properNoun
Virwani	Virwani	properNoun
Faur	Faure	properNoun
Garoyan	Garoyan	properNoun
Koromacno	Koromacno	properNoun
Karpenko	Karpenko	properNoun
Necati	Necati	properNoun
Garana	Garena	properNoun
Bayraktar	Bayraktar	properNoun
Turgovishte	Turgovishte	properNoun
Ivanjicki	Ivanjicki	properNoun
Telnor	Télégraphie	properNoun
Dogus	Dogus	properNoun
Costea	Costea	properNoun
Peykov	Peykov	properNoun
Uday	Uday	properNoun
Peron	Péron	properNoun
Oberschledorn	Oberschledorn	properNoun
Terim	Terim	properNoun
Knezevo	Knezevo	properNoun
Tsipras	Tsipras	properNoun
Efstratios	Efstratios	properNoun
Anastassis	Anastasssis	properNoun
plebian	plébétueux	properNoun
Lebensraum	Lebensreum	properNoun
Annen	Annexe	properNoun
Merck	Merck	properNoun
Rize	Rize	properNoun
Koltai	Koltaï	properNoun
Erinc	Erinc	properNoun
Berovo	Bervo	properNoun
Stufstock	Stufstock	properNoun
Rasim	Rasim	properNoun
Bolanos	Bolanos	properNoun
Korman	Korman	properNoun
WindJet	Roue	properNoun
Akbiyiklioglu	Akbiyiklioglu	properNoun
Fethullah	Féhollah	properNoun
Obala	Obala	properNoun
Borssen	Borssen	properNoun
Koni	Koni	properNoun
Honig	Honoraire	properNoun
Hajri	Hajri	properNoun
Vasil	Vasil	properNoun
Shalom	Shalom	properNoun
Mirita	Mirita	properNoun
Efendi	Efendi	properNoun
Zravko	Zdravko	properNoun
Shinawatra	Shinawatra	properNoun
Blunkett	Blunkett	properNoun
Uka	Uka	properNoun
Mandru	Mandru	properNoun
Neykov	NEYKOV	properNoun
Sekula	Sekula	properNoun
Sezin	Sezin	properNoun
Electroputere	Électropoutère	properNoun
Duvac	Duvac	properNoun
Hyland	Hyland	properNoun
Mitchener	Mitchener	properNoun
Risima	Risima	properNoun
Makfut	Makaud	properNoun
Ervin	Ervin	properNoun
Hamad	Hamad	properNoun
Simeonov	Simonov	properNoun
Vanhanen	Vanhanen	properNoun
Baumgarten	Baumgarten	properNoun
Tijanic	Tijanic	properNoun
Zaharieva	Zaharieva	properNoun
Omcikus	Omcikus	properNoun
Shmatko	Shmatko	properNoun
Vegeta	Végéta	properNoun
Teofilovic	Teofilovic	properNoun
Albtelekom	Albelecom	properNoun
Elbasani	Elbasani	properNoun
Livni	Livni	properNoun
Medenica	Medenica	properNoun
Tlax	Tlax	properNoun
Buftea	Bêtise	properNoun
Agrana	Agrana	properNoun
Speckhard	Speckhard	properNoun
Prela	Prela	properNoun
Lepenski	LEPENSKI	properNoun
Oinouses	Originale	properNoun
Itsu	Itsu	properNoun
Nedelcho	Nedelcho	properNoun
Kavgic	Kavgique	properNoun
Sturdza	Sturdza	properNoun
Eurovia	Eurovia	properNoun
Dranoc	Dranoc	properNoun
Pendeli	Pendeli	properNoun
Pljevlja	Pljevlja	properNoun
Evriviades	Evriviades	properNoun
Samourkasidis	Samourkasidis	properNoun
Ivailo	Ivailo	properNoun
Melita	Mélita	properNoun
Pozdniakov	Pozdniakov	properNoun
Pall	le voile	noun
Pall	le drap mortuaire	noun
Pall	le poêle	noun
Pall	le manteau	noun
Pall	le pallium	noun
Pall	perdre son charme	verb
Pall	devenir maigre	verb
Pall	affaiblir	verb
Pall	Voile	None
Dejan	Dejan	properNoun
Rezart	Ronchonner	properNoun
Baesu	Baesu	properNoun
Greenfield	Greenfield	properNoun
Staparac	Stapaac	properNoun
Tsatouha	Tsatouha	properNoun
Sarigul	Sarigul	properNoun
Andonov	Andonov	properNoun
Liapsis	Lioissi	properNoun
Tsonev	Tsonev	properNoun
Papageorgopoulos	Papageorgopoulos	properNoun
Iweala	Iweala	properNoun
Natali	Natali	properNoun
Mandravelis	Mandravelis	properNoun
Parnassos	Parnassos	properNoun
Propylaia	Propylaia	properNoun
Komercijalna	Komercijalna	properNoun
Karatoprak	Karatoprak	properNoun
Jurnalul	Jurnalul	properNoun
Oender	Oqueuse	properNoun
Lithio	Lithio	properNoun
Alemdar	Alemdar	properNoun
Sadiku	Sadiku	properNoun
Kazandzhiev	Kazandzhiev	properNoun
Owada	Owada	properNoun
Razgrad	Razgrad	properNoun
Prlicev	Prlicev	properNoun
Kolsh	Kolsch	properNoun
Oxi	Oxi	properNoun
Kocaeli	Kocaeli	properNoun
Hodja	Hodja	properNoun
Ciragan	Ciragan	properNoun
Henman	Henman	properNoun
Qaradawi	Qaradawi	properNoun
Ciechanover	Ciechanovré	properNoun
Rafiq	Rafiq	properNoun
Abdal	Abdal	properNoun
Karsan	Karsan	properNoun
Ajete	Ajete	properNoun
Arta	Arta	properNoun
Berat	Berat	properNoun
Friso	Friso	properNoun
Eslen	Eslen	properNoun
Hiller	Hiver	properNoun
Onisei	Onisei	properNoun
Dragnic	Dragnique	properNoun
Dragalic	Dragalique	properNoun
Helidon	Hélidon	properNoun
Tengelmann	Tengelmann	properNoun
Trebevic	Treebevic	properNoun
Sesli	Sesli	properNoun
Dulgerler	Dulgerler	properNoun
Spens	S'épanouir	properNoun
Kalanovic	Kalanovic	properNoun
Veysel	Veyette	properNoun
Fokas	Fokas	properNoun
Vivacom	Vivacom	properNoun
Sihamir	Sihamir	properNoun
Awedan	Awedan	properNoun
Pavlovska	Pavlovska	properNoun
Pacolli	Pacolli	properNoun
Intralot	Intralot	properNoun
Platonos	Platonos	properNoun
Excel	exceller	verb
Excel	surpasser	verb
Excel	se dépasser	verb
Excel	se surpasser	verb
Excel	Exceller	None
Zachopoulos	Zachopoulos	properNoun
Dag	Drainer	properNoun
Delchev	Drainer	properNoun
Vjestica	Vjestica	properNoun
Pizzeria	la pizzeria	noun
Pizzeria	Pizzeria	None
Vorobyov	Vorobyov	properNoun
Pantelic	Pantelic	properNoun
Mikov	Mikov	properNoun
Myrtaj	Myrtaj	properNoun
Himara	Himara	properNoun
Zenzile	Zénzile	properNoun
Logar	Amortissement	properNoun
Stefco	Stefco	properNoun
Tomsic	Tomatique	properNoun
Karayiannidis	Karayiannidis	properNoun
Vranješ	Vranješ	properNoun
Ruyter	Ruyter	properNoun
Gaso	Gaso	properNoun
Erogul	Erogul	properNoun
Saletovic	Salévic	properNoun
Sirat	Sirat	properNoun
Blagojevic	Blagojevic	properNoun
Sokratis	Sokratis	properNoun
Atrida	Atrida	properNoun
Mutafchieva	Mutafchieva	properNoun
Eurimages	Eurimages	properNoun
Il	Il	properNoun
Dinc	Dinc	properNoun
Ozden	Ozden	properNoun
Karadimos	Karadimos	properNoun
Kezman	Kezman	properNoun
MediaSaturn	Mediaturn	properNoun
Barabas	Mediaturn	properNoun
Kvechi	Kvechi	properNoun
Apostolov	Apostolov	properNoun
Pozarevac	Pozarevac	properNoun
Tsipora	Tsipora	properNoun
Dibra	Dibra	properNoun
Kutlu	Kutlu	properNoun
Eminonu	Eminonu	properNoun
Goetze	Getze	properNoun
Moralis	Moralis	properNoun
Ilie	Je ments	properNoun
Celikovic	Celikovic	properNoun
Kosovalive	Kosovalive	properNoun
Mesrob	Mésrob	properNoun
Ruoss	Ruisseler	properNoun
Bezlov	Bezlov	properNoun
Bobov	Bobov	properNoun
Tsvilou	Tsvilou	properNoun
Sengul	Sengul	properNoun
Referans	Référencier	properNoun
Wen	la loupe	noun
Wen	Loupe	None
Rubinstein	Rubinstein	properNoun
Shantek	Shantek	properNoun
Nezilovo	Nezilovo	properNoun
Fetih	Fetih	properNoun
Uldedaj	Udedaj	properNoun
Manderson	Manders	properNoun
Samecki	Samecki	properNoun
Bayik	Bayik	properNoun
Taracila	Taracila	properNoun
Adili	Adili	properNoun
Pardew	Pardinette	properNoun
Costopoulos	Costopoulos	properNoun
Teva	Teva	properNoun
Zentropa	Zentropa	properNoun
Colizzi	Colizzi	properNoun
Tuncag	Tuncag	properNoun
Intesa	Intesa	properNoun
Belgacom	Belgacom	properNoun
Agim	Agim	properNoun
Lale	Lale	properNoun
Heydar	Heydar	properNoun
Leers	Lien	properNoun
Colville	Colville	properNoun
Camorra	Camorra	properNoun
Seidl	Seidl	properNoun
Dafina	Dafina	properNoun
Prespes	Présider	properNoun
Castus	Caste	properNoun
Efthymiou	Efthymiou	properNoun
Acatrinei	Acatrinei	properNoun
Dokuz	Dokuz	properNoun
Klokot	Klokot	properNoun
Albanese	Albanais	properNoun
Ardit	Ardeur	properNoun
Makis	Makis	properNoun
Servet	Servie	properNoun
Tineriti	Tinériti	properNoun
Bulut	Bulut	properNoun
Embiricos	Embirilos	properNoun
Stojkovska	Stojkovska	properNoun
Enaam	Enaam	properNoun
Volkovo	Volkovo	properNoun
Sasmaz	Sasmes	properNoun
Financier	le financier	noun
Financier	le brasseur d'affaires	noun
Financier	Financier	None
Fejzullah	Fejzullah	properNoun
Frendo	Frendre	properNoun
Hur	Faire disparaître	properNoun
Lubbers	Lubrifier	properNoun
TurkStat	Turkstat	properNoun
Kunovac	Kunovac	properNoun
Velimir	Velimir	properNoun
Hidetoshi	Hidetoshi	properNoun
Rousinov	Rousinov	properNoun
Molossa	Molossa	properNoun
Nevenka	Nevenka	properNoun
Calivis	Calivis	properNoun
Bejtullahu	Bejtullahu	properNoun
Toma	Toma	properNoun
Svatizky	Svatizky	properNoun
Iskrov	Iskrov	properNoun
Likovic	Convaincu	properNoun
Gruzniczki	Gruzniczki	properNoun
Sahimi	Sahimi	properNoun
Karagounis	Karagounis	properNoun
Kirin	Kirin	properNoun
Asya	Asya	properNoun
Konce	Konce	properNoun
Vrana	Vrana	properNoun
Sismanogleio	SismanOronio	properNoun
Basbug	Basbug	properNoun
Patzelt	Patzelt	properNoun
Oyan	Oyan	properNoun
Popeski	Popeski	properNoun
Picchu	Picchu	properNoun
Imeraj	Imauj	properNoun
Fari	Fari	properNoun
Rhijn	Rhijn	properNoun
Zagaris	Zagaris	properNoun
Maritsa	Maritsa	properNoun
Majko	Majko	properNoun
Haneke	Haneke	properNoun
Makanova	Makanova	properNoun
Equest	Épargner	properNoun
Kipchom	Kipchom	properNoun
Istinye	Istinye	properNoun
Munjin	Munjin	properNoun
Haysom	Haysom	properNoun
Schomburg	Schomburg	properNoun
Zejnullah	Zejnullah	properNoun
Selami	Selami	properNoun
Suntaru	Suntaru	properNoun
Gatalo	Gatalo	properNoun
Riza	Riza	properNoun
Ciflik	CIFLIK	properNoun
Aktug	Aktug	properNoun
Sachinidis	Sachinidis	properNoun
Blanckert	Blanckert	properNoun
Papaloukas	Papalloukas	properNoun
Bangguo	Bangguo	properNoun
Ostrog	Ostrog	properNoun
Shkelzen	Shkelzen	properNoun
Predela	Predela	properNoun
Lokomotiva	Lokomotiva	properNoun
Preuss	Prétention	properNoun
Drtia	Drtiaque	properNoun
Kakarantzas	Kakarantzas	properNoun
Dinopoulos	Dinopoulos	properNoun
Bujas	Bujas	properNoun
Mehmedbasic	MEHMEDBASIC	properNoun
Mehandziski	Mehandziski	properNoun
Beyoglu	Beyoglu	properNoun
Busteni	Busteni	properNoun
Nicusor	Nénus	properNoun
Multu	Gros	properNoun
ProSport	Prosport	properNoun
Nelen	Nelen	properNoun
Teodor	Teodor	properNoun
Muratagic	Muraturien	properNoun
Radisav	Radisav	properNoun
Danco	Danco	properNoun
Orbovic	Orbovic	properNoun
Vltavou	Vltavou	properNoun
Rupel	Rupel	properNoun
Sepp	Sévère	properNoun
Munter	Munote	properNoun
Kaltsiki	Kaltsiki	properNoun
Helmes	Helmes	properNoun
Konculj	Konculj	properNoun
Maram	Maramin	properNoun
Pokos	Pokos	properNoun
Adlington	Adlington	properNoun
Efes	Efès	properNoun
Vladeta	Vladeta	properNoun
Elektropolog	Elektropology	properNoun
Haber	Habper	properNoun
Eskandari	Eskandari	properNoun
Huebner	Huebner	properNoun
Balaceanu	Balacéanu	properNoun
Kirklareli	Kirklareli	properNoun
Ahunbay	Ahunbay	properNoun
Tornatore	Tornatore	properNoun
Barajevo	Barajevo	properNoun
Turceni	Turceni	properNoun
Adha	Turceni	properNoun
Duferco	Duferco	properNoun
Profi	Profi	properNoun
Polozani	Polozani	properNoun
Fojnica	Fojnica	properNoun
Vranica	Vranica	properNoun
Iskra	Iskra	properNoun
Ulema	Uléma	properNoun
Mylonakis	Mylonakis	properNoun
Panayotov	Panayotov	properNoun
Kremnik	Kremnik	properNoun
Svetelsek	Svetelsek	properNoun
Xinghua	Xinghua	properNoun
Bilejic	Bélier	properNoun
Proxima	Proximum	properNoun
Vis	Visiter	properNoun
Kempinski	Kempinski	properNoun
Kaegi	Kaïegi	properNoun
Upliana	Upliana	properNoun
Mersid	Merside	properNoun
Ender	Endurance	properNoun
Lolos	Lolos	properNoun
Kroling	Kroling	properNoun
Dror	Drorness	properNoun
Mavroraki	Drorness	properNoun
Santrac	Santrac	properNoun
Impregilo	Imprégné	properNoun
Bianet	Bianet	properNoun
Darussafaka	Darussafaka	properNoun
Davidoff	Davidoff	properNoun
Glick	Glick	properNoun
Katsuya	Katsuya	properNoun
Farrizi	Farrizi	properNoun
Sazan	Sazan	properNoun
Rokaj	Rokaj	properNoun
Fourlis	Fourlis	properNoun
Komerc	Komerc	properNoun
Tavlan	Tavlan	properNoun
Gradiste	Diplômé	properNoun
bridle	la bride	noun
bridle	brider	verb
bridle	mettre la bride à	verb
bridle	bride	None
Rudozem	Rudozem	properNoun
Palislamovic	Palislamovic	properNoun
Ohrid	Ohrid	properNoun
Zaitsev	Zaitsev	properNoun
Ledra	LEDRA	properNoun
Petsalnikos	Petsalnikos	properNoun
Mijailovic	Mijailovic	properNoun
Anjeza	Anjeza	properNoun
Kajin	Kajin	properNoun
Shan	Shan	properNoun
Ilona	Ilona	properNoun
Provadia	Provisoire	properNoun
Vranjkovic	Vranjkovic	properNoun
Beckovic	Beckovic	properNoun
Hepok	Hepok	properNoun
Zakhem	Zakhem	properNoun
Sasakawa	Sasakawa	properNoun
Paci	Paci	properNoun
Kalemegdan	Kalemegdan	properNoun
Muzaffer	Muzaffer	properNoun
Pango	Pango	properNoun
Imami	Imami	properNoun
Velkovski	Velkovski	properNoun
Goulandris	Goulandris	properNoun
Wiesel	Wiesel	properNoun
Ulkersport	Ulkersport	properNoun
Cifligu	Cifligu	properNoun
InPharm	Inphère	properNoun
Kis	Kis	properNoun
Brodarac	Brodarac	properNoun
Samoilova	Samoilova	properNoun
Koshlukov	Koshlukov	properNoun
Neikova	Néikova	properNoun
Cakala	Cakala	properNoun
Geylani	Geylani	properNoun
Kuzmanovska	Kuzmanovska	properNoun
Nigrutin	Nigrutine	properNoun
Privredna	Privila	properNoun
Kypseli	Kypse	properNoun
Naohiro	Naohiro	properNoun
Entegre	Naohiro	properNoun
Ertan	Ertan	properNoun
Armida	Armida	properNoun
Baska	Baska	properNoun
Dagdeviren	Dagadeviren	properNoun
Heckler	le siffleur	noun
Heckler	Heckler	None
Ineco	Inéco	properNoun
Hassler	Hassler	properNoun
Bukagili	Bukagili	properNoun
Polancec	Polancète	properNoun
Ula	Ula	properNoun
Stiegler	Stiegler	properNoun
Alp	Alp	properNoun
Hotamisligil	Hottamisligil	properNoun
Ndue	Ndue	properNoun
Kucan	Kucan	properNoun
Sheleva	Sheleva	properNoun
Steny	Stenmable	properNoun
Belenli	Belenli	properNoun
Hossein	Hossein	properNoun
Galevi	Galevi	properNoun
Filizler	Filizer	properNoun
Manmohan	Manmohan	properNoun
Petzetakis	Petzétatakis	properNoun
Enesa	Enesa	properNoun
Kolar	Kolar	properNoun
Toranica	Toranique	properNoun
Aro	Aro	properNoun
Lavara	Lavara	properNoun
Papadimitrou	Papadimitriou	properNoun
Vushtrri	Vushtrri	properNoun
Onen	Sur	properNoun
Oja	OJA	properNoun
Timofte	Timofte	properNoun
Ziarul	Timofte	properNoun
Tabanli	Tabanli	properNoun
Nisomnia	Nisomnie	properNoun
Darvas	Darvas	properNoun
Akkurt	Akkurt	properNoun
Kentera	Kentera	properNoun
Trivian	Trivian	properNoun
Tanith	Tanith	properNoun
Mikis	Mikis	properNoun
Sfir	Sfir	properNoun
Vasileilos	Vasililos	properNoun
Rachid	Rachid	properNoun
Avioane	Avioane	properNoun
Tskhinvali	Tskhinvali	properNoun
Klamm	Klamm	properNoun
Bala	Bala	properNoun
Snidarsic	Snidarsique	properNoun
Stamatovic	Stamatovic	properNoun
Esenboga	Esenboga	properNoun
Glogovac	Glogovac	properNoun
Hekuran	Hekuran	properNoun
Velivassakis	Velivassakis	properNoun
Kosutovo	Kosutovo	properNoun
Shlomo	Shlomo	properNoun
Nozari	Nozari	properNoun
Kotorska	Kotorska	properNoun
Bora	la bora	noun
Bora	Bora	None
Manze	Manze	properNoun
Krstimir	Manze	properNoun
Komandarev	Komandarev	properNoun
Klodian	Klodian	properNoun
Karup	Karup	properNoun
Mitar	Mitar	properNoun
Posusje	Posusje	properNoun
Cerkezi	Cerkezi	properNoun
Kanelli	Kanelli	properNoun
Cismarescu	Cismaescu	properNoun
Bradisteanu	Bradisteanu	properNoun
Feyzulahu	Feyzulahu	properNoun
Leger	Léger	properNoun
Buyukada	Buyukada	properNoun
Arkeopark	Archéoparcien	properNoun
Hoeij	Hoeij	properNoun
Naoussa	Naoussa	properNoun
Bolero	le boléro	noun
Bolero	Boléro	None
Dirani	Diran	properNoun
Zorlu	Zorlu	properNoun
Pernicka	Pernicka	properNoun
Razzoli	Razzoli	properNoun
Enoikiazetai	Enoikiazetai	properNoun
Bazaj	Bazaj	properNoun
Mardy	Marin	properNoun
Krastyo	Krastyo	properNoun
Bartle	Bartle	properNoun
Inonu	Bartle	properNoun
Pharma	Pharma	properNoun
Mol	Molle	properNoun
Stanko	Hargneux	properNoun
Kerveshi	Kervehi	properNoun
Kosovac	Kosovac	properNoun
Borovo	Borovo	properNoun
Parthenon	le Parthénon	noun
Parthenon	Parthénon	None
Kalantzis	Kalantzis	properNoun
Seggelen	Seggelen	properNoun
Kalaja	Seggelen	properNoun
Sijekovac	Sijekovac	properNoun
Arapkoy	Arapkoy	properNoun
Bukovac	Bukovac	properNoun
Kirilenko	Kirilenko	properNoun
Lackovic	Lackovic	properNoun
Suada	SUADA	properNoun
Gruda	Gruau	properNoun
Metatabak	Métatabak	properNoun
Beadini	Bourreau	properNoun
Hasei	Hasei	properNoun
Akman	Akman	properNoun
Anastas	Anastas	properNoun
Mazeikiu	Mazeikiu	properNoun
Aloglu	Aloglu	properNoun
Sozluk	Sozluk	properNoun
Sadaric	Sadaric	properNoun
Pamboukis	Pamboukis	properNoun
Severoni	Severoni	properNoun
Dukat	Dukat	properNoun
Abduladhim	Abduladhim	properNoun
Kisho	Kisho	properNoun
Irsen	Irsen	properNoun
Garo	Garo	properNoun
Cetinski	Cétinki	properNoun
Wahlstrom	Wahlstrom	properNoun
Dabilis	Dropis	properNoun
Samukhin	Samukhin	properNoun
be a success	être un succès	properNoun
Oikonomou	Oikonomou	properNoun
Sevdija	Sevdija	properNoun
Ladino	Ladino	properNoun
Imre	Imre	properNoun
Tahirovic	Tahirovic	properNoun
Dedic	Dédic	properNoun
Praha	Praha	properNoun
Lohan	Lohan	properNoun
Obren	Obren	properNoun
Mutuki	Mutuki	properNoun
Kiossovski	Kiossovski	properNoun
Helfen	Kiossovski	properNoun
Dogru	Dogru	properNoun
Zumax	Zumax	properNoun
Incekara	Incekara	properNoun
Dajt	Dajt	properNoun
Toure	Toure	properNoun
Skenderija	Skenderija	properNoun
Subotica	Subotica	properNoun
Rusmajli	Rusmajli	properNoun
Cosco	Cosco	properNoun
Agrokop	Abroger	properNoun
Sipahioglou	Abroger	properNoun
Canetti	Canetti	properNoun
Rasit	Rasoir	properNoun
Naxos	Naxos	properNoun
Achilleos	Achilleos	properNoun
Kirdar	Achilleos	properNoun
Hamzaj	Hamzaj	properNoun
Loso	Loso	properNoun
Debarca	Débarca	properNoun
Geleva	Geleva	properNoun
Balchik	Balchik	properNoun
Varvitsiotis	Varvitsiotis	properNoun
Delic	Délicat	properNoun
Arifi	Arifi	properNoun
Stavrakis	Stavrakis	properNoun
Dablis	Dablis	properNoun
Domaine	Domaine	properNoun
Zubin	Zubin	properNoun
Stonestreet	Stonestreet	properNoun
Ras	le ras	noun
Ras	Ras	None
Letu	Te laisser	properNoun
Karremans	Karremans	properNoun
Hintz	Hintz	properNoun
Baris	Baris	properNoun
Birol	Birol	properNoun
Actualitati	Actualitati	properNoun
Bukejlovic	Bukejlovic	properNoun
Velefarm	Velefarm	properNoun
Korotishkin	Korotishine	properNoun
Kombit	Kombit	properNoun
Tallil	Tension	properNoun
Cancescu	CANSCU	properNoun
Continentalna	Continentala	properNoun
Knez	Knez	properNoun
Sekerbank	Sekerbank	properNoun
Tegeltija	Tegeltija	properNoun
Nikolaidis	Nikolaidis	properNoun
Ekathemerini	Ekathimerini	properNoun
Chelton	Chélton	properNoun
Igia	Igia	properNoun
Hrebenciuc	Hrebenciuc	properNoun
Documentarist	Documentaire	properNoun
Antholz	Antholz	properNoun
Waili	Waili	properNoun
Karabelas	Karabelas	properNoun
Stricker	Tristesse	properNoun
Mecon	Mecon	properNoun
Kljajevic	Kljajevic	properNoun
Remi	Remi	properNoun
Zuko	Zuko	properNoun
Krastev	Krastev	properNoun
Pesek	Peser	properNoun
Karaf	Karaf	properNoun
Gorica	Gorica	properNoun
Zika	Zika	properNoun
Grajcevci	Grajcevci	properNoun
belong to	appartenir à	properNoun
Marcoullis	Marcoullis	properNoun
Durres	Durres	properNoun
Milaqi	Milaqi	properNoun
Himeneza	Himenza	properNoun
Ajetul	Ajetul	properNoun
Soyan	Soja	properNoun
Diamantis	Diamantis	properNoun
Vatovci	Vatovci	properNoun
Azarenka	Azarenka	properNoun
Permet	Permutation	properNoun
Saar	Saillie	properNoun
Gievska	Gievska	properNoun
Grlica	Granica	properNoun
Kaludjerica	Kaludjerica	properNoun
Kasumi	Kasumi	properNoun
Parvomay	Parvomay	properNoun
Cosmopolitan	cosmopolite	adjective
Cosmopolitan	cosmopolite	noun
Cosmopolitan	Cosmopolite	None
Sata	SATA	properNoun
Els	Els	properNoun
Stojance	Els	properNoun
Naftex	Naftex	properNoun
Ciorba	Ciorba	properNoun
Kavarna	Kavarna	properNoun
Culibrk	Cinculade	properNoun
Eraslan	Eraslan	properNoun
Slavonije	Slavonije	properNoun
Zec	Zec	properNoun
Slaveikov	Slaveikov	properNoun
Albiceleste	Albiceleste	properNoun
Macosped	Macospé	properNoun
Gel	le gel	noun
Gel	le colloïde	noun
Gel	épaissir	verb
Gel	prendre tournure	verb
Gel	Gel	None
Armagan	Armagan	properNoun
Silvestri	Silvestri	properNoun
Nekibe	Nekibe	properNoun
Swedmilk	Swedmilk	properNoun
Dafovska	Dafovska	properNoun
Cvijic	Cvijic	properNoun
Podvig	Podvig	properNoun
Petrila	Pétrilier	properNoun
Inis	Inis	properNoun
Bolles	Bolles	properNoun
Danas	Danas	properNoun
as opposed to	par opposition à	properNoun
Trut	Trut	properNoun
Activa	Activa	properNoun
Zupcici	Zupcici	properNoun
Rulu	Rugueux	properNoun
Lertcheewakarn	Lertcheewakarn	properNoun
Monson	Monson	properNoun
Kanceska	Kanceska	properNoun
Arberie	Arbere	properNoun
Boli	Boli	properNoun
Trifu	Tremblement de terre	properNoun
Sintofarm	Sintofarm	properNoun
Vedomosti	Vedomosti	properNoun
Divna	Divna	properNoun
Merita	Mérita	properNoun
Elikona	Elikona	properNoun
Doga	Doga	properNoun
Baykal	Baykal	properNoun
Panayiotou	Panayiotou	properNoun
Silivri	Silivri	properNoun
Indesit	Indesiter	properNoun
Shinada	Shinada	properNoun
Miljacka	Miljacka	properNoun
Trichet	Trichet	properNoun
Nistrului	Nistrului	properNoun
Turker	Tourbillon	properNoun
Hayal	Hayal	properNoun
Istikamet	Istikamet	properNoun
Mangalia	Mangionnaire	properNoun
Shabanaj	Shabanaj	properNoun
Karantena	Karantena	properNoun
Mixhait	Mixhait	properNoun
Bukov	Bukov	properNoun
Kroon	Kroon	properNoun
Tsoumeleka	Tsoumeleka	properNoun
Veterina	Vétérina	properNoun
Gokceada	Gokpeada	properNoun
Diyakbakir	Diyarbakir	properNoun
Mavrodiev	Mavrodiev	properNoun
Tatl	Tatl	properNoun
Rivoseki	Rivoseki	properNoun
Franek	Franek	properNoun
Farmland	Les terres agricoles	properNoun
Poneman	Poneman	properNoun
Niš	Niš	properNoun
Percinkov	Percinkov	properNoun
Vrnjackabanja	Vrnjackabanja	properNoun
Mirosnicenko	Mirosnicenko	properNoun
Bukoshi	Bukoshi	properNoun
Srbac	Srbac	properNoun
Demichelis	Demichelis	properNoun
Izmit	Izmit	properNoun
Akos	Akos	properNoun
Grncarica	Grncarica	properNoun
Autohellas	Authellas	properNoun
Stoilova	Soilova	properNoun
Zypries	Zypries	properNoun
Moraca	Moraca	properNoun
Peza	Peza	properNoun
Seyhan	Seyhan	properNoun
Fehrenbach	Fehrenbach	properNoun
Poyrazkoy	Poyrazkoy	properNoun
Grama	Poyrazkoy	properNoun
Birsa	Birsa	properNoun
Alekos	Alekos	properNoun
Braathu	Braathu	properNoun
at the age of	à l'âge de	properNoun
Babiuc	Babiuc	properNoun
Anvers	Anvers	properNoun
Azimov	Azimov	properNoun
Stasi	Stasi	properNoun
Magneti	Magnéti	properNoun
Promedia	Promédie	properNoun
Tecuceanu	Técuceanu	properNoun
Simplu	Simplu	properNoun
Vurgu	Vurgu	properNoun
Autobahn	AUTOBAHN	properNoun
Cigovski	Cigovski	properNoun
Aconcagua	Aconcagua	properNoun
Hajra	Hajra	properNoun
Agrovojvodina	Agrovojvodina	properNoun
Mystakidou	Mystakidou	properNoun
Ziraat	Ziraat	properNoun
Sounio	Sounio	properNoun
Moskvy	Moschain	properNoun
Finiq	Finiq	properNoun
Ip	Ip	properNoun
Trivan	Triva	properNoun
Sterija	Sterija	properNoun
Drin	Drin	properNoun
Csernescki	Csernescki	properNoun
Ginaki	Ginaki	properNoun
Vajda	Vajda	properNoun
Kovic	Kovic	properNoun
Zuma	Zuma	properNoun
Ariton	Ariton	properNoun
Zvonareva	Zvonareva	properNoun
Piralkov	Piralkov	properNoun
Rafajlovska	Rafajlovski	properNoun
Erkki	Erkki	properNoun
Dede	Déléguer	properNoun
Liburn	Liburn	properNoun
Spomenka	Spomenka	properNoun
Milaim	Milaim	properNoun
Ercan	Ercan	properNoun
Radavc	Radavc	properNoun
Ozdag	Ozdag	properNoun
Rangelov	Rangelov	properNoun
Chernomyrdin	Chernomyrdin	properNoun
Lajic	Lajic	properNoun
Zdenko	Zddenko	properNoun
Silia	Silia	properNoun
Sentetik	Senetik	properNoun
Kezimi	Kezimi	properNoun
the many	le nombre	properNoun
Sorbonne	Sorbonne	properNoun
Kalyon	Kalyon	properNoun
Atifete	Atifète	properNoun
Zlatko	Zlatko	properNoun
Ingerson	Ingerson	properNoun
pre-mark	pré-marquer	properNoun
Borko	Borko	properNoun
Tifa	Tifa	properNoun
Blloshmi	Blloshmi	properNoun
Velaj	Velaj	properNoun
Caritas	Caritas	properNoun
Mucella	Mucella	properNoun
Egaleo	Égaleo	properNoun
Madamaiya	Madamaiya	properNoun
Trajce	Trajce	properNoun
Kocharian	Kocharien	properNoun
Carniola	Carniole	properNoun
Isbank	Isbank	properNoun
Fokker	Fokker	properNoun
Herwig	Herwig	properNoun
Gaddi	Gaddi	properNoun
Piotr	Piotr	properNoun
Zarqawi	Zarqawi	properNoun
Radelscu	Radelscu	properNoun
Alaattin	Alaattine	properNoun
Karahoda	Karahoda	properNoun
Wolfensohn	Wolfensohn	properNoun
Vevcani	Vovciani	properNoun
Dashamir	Datant	properNoun
Stoichkovs	Stoichkov	properNoun
Nafisse	Nafisse	properNoun
Energyobserver	Observateur énergétique	properNoun
Azis	Azis	properNoun
Kohajone	Kohajone	properNoun
Smokova	Smokova	properNoun
Danaci	Danaci	properNoun
Schmied	Danaci	properNoun
Cuoto	Cuoto	properNoun
Levijatan	Lévijatan	properNoun
Bajovic	Bajovic	properNoun
Kavake	Kavake	properNoun
Domazetova	Domazetova	properNoun
Ergun	Ergun	properNoun
Biltis	Biltis	properNoun
profit from	profit de	properNoun
Ersi	Ersi	properNoun
Wilfried	Wilfried	properNoun
Godoy	Godoy	properNoun
Malisevo	Malisevo	properNoun
Erel	Éreller	properNoun
Peci	Peci	properNoun
Barns	la grange	noun
Barns	l' étable	noun
Barns	l' écurie	noun
Barns	Grange	None
Nemcsik	Nemcsik	properNoun
Gruja	Gruja	properNoun
Figel	Figure	properNoun
Somer	Somer	properNoun
Gredelj	Gredelj	properNoun
Havilland	Havilland	properNoun
Ruegen	Ruegen	properNoun
Sorin	Sorin	properNoun
Palanski	Palanski	properNoun
Goksin	Garsin	properNoun
wind down	se traîner	properNoun
Shenzhen	Shenzhen	properNoun
Temov	Temov	properNoun
Ghosh	Grognon	properNoun
Frécon	Frécon	properNoun
Ilko	Ilko	properNoun
Protaras	Protaas	properNoun
Kreator	Kreator	properNoun
Torosidis	Torosidis	properNoun
Actmedia	Actemedia	properNoun
Lushta	Lushta	properNoun
Bornova	Bornova	properNoun
Kwai	Kwai	properNoun
Andov	Andov	properNoun
Albu	Albuvier	properNoun
Vassilev	Vassilev	properNoun
